Name,Description,Combined Group,Unique Machines,Unique UserID, Count F,Count H,EULA Machines
,"",_1,187,162,159,20,179
,"",_2,74,72,30,39,69
,"",_3,49,41,39,3,42
,"",_22,44,25,43,1,44
,"",_4,39,38,23,7,30
,"",_5,38,33,19,3,22
,"",_6,35,34,25,1,26
,"",_8,32,28,23,2,25
,"",_20,31,26,28,1,29
,"",_13,29,27,15,0,15
,"",_21,27,21,25,0,25
,"",_11,25,24,21,1,22
,"",_7,24,23,11,0,11
,"",_10,24,23,17,1,18
,"",_26,23,17,23,0,23
,"",_23,22,15,22,0,22
,"",_24,20,19,20,0,20
,"",_25,19,17,19,0,19
,"",_27,16,16,0,0,0
,"",_12,15,15,7,2,9
,"",_29,14,13,14,0,14
,"",_9,13,13,9,0,9
,"",_14,13,11,4,0,4
,"",_17,13,13,9,0,9
,"",_30,13,12,12,1,13
,"",_31,13,13,12,0,12
,"",_34,13,13,2,0,2
,"",_39,12,11,12,0,12
,"",_33,11,10,10,0,10
,"",_37,11,11,11,0,11
,"",_15,10,10,4,2,6
,"",_19,10,11,7,2,9
,"",_44,10,10,7,0,7
,"",_16,9,8,7,1,8
,"",_35,9,7,6,0,6
,"",_40,9,6,6,2,8
,"",_41,9,9,9,0,9
,"",_47,9,8,8,0,8
,"",_49,9,8,9,0,9
,"",_52,9,9,0,0,0
,"",_104,9,3,3,0,3
,"",_38,8,6,5,0,5
,"",_36,7,3,3,0,3
,"",_57,7,6,7,0,7
,"",_18,6,6,5,0,5
,"",_43,6,6,1,0,1
,"",_45,6,6,5,0,5
,"",_48,6,5,2,0,2
,"",_53,6,4,6,0,6
,"",_54,6,5,5,0,5
,"",_59,6,5,4,0,4
,"",_62,6,5,4,0,4
,"",_63,6,5,5,0,5
,"",_70,6,3,5,0,5
,"",_81,6,5,6,0,6
,"",_50,5,5,5,0,5
,"",_55,5,5,0,0,0
,"",_61,5,4,0,0,0
,"",_65,5,4,4,0,4
,"",_66,5,3,1,0,1
,"",_75,5,5,5,0,5
,"",_80,5,5,4,1,5
,"",_96,5,4,5,0,5
,"",_100,5,4,5,0,5
,"",_111,5,4,5,0,5
,"",_28,4,3,4,0,4
,"",_58,4,3,4,0,4
,"",_64,4,3,2,0,2
,"",_69,4,4,4,0,4
,"",_76,4,4,4,0,4
,"",_85,4,4,1,0,1
,"",_86,4,4,2,0,2
,"",_87,4,1,4,0,4
,"",_89,4,4,2,0,2
,"",_90,4,3,4,0,4
,"",_93,4,4,4,0,4
,"",_112,4,3,4,0,4
,"",_130,4,2,3,0,3
,"",_148,4,3,0,0,0
,"",_158,4,2,3,0,3
,"",_166,4,2,3,1,4
,"",_46,3,2,3,0,3
,"",_68,3,3,3,0,3
,"",_71,3,2,0,0,0
,"",_72,3,3,3,0,3
,"",_77,3,3,3,0,3
,"",_83,3,3,2,0,2
,"",_92,3,3,3,0,3
,"",_94,3,3,2,0,2
,"",_102,3,4,1,0,1
,"",_103,3,3,2,0,2
,"",_105,3,2,2,0,2
,"",_113,3,3,3,0,3
,"",_121,3,3,3,0,3
,"",_122,3,3,2,1,3
,"",_123,3,2,3,0,3
,"",_135,3,3,2,0,2
,"",_136,3,3,3,0,3
,"",_137,3,3,2,0,2
,"",_145,3,3,3,0,3
,"",_151,3,2,3,0,3
,"",_154,3,3,3,0,3
,"",_163,3,2,3,0,3
,"",_167,3,2,3,0,3
,"",_169,3,2,3,0,3
,"",_170,3,3,3,0,3
,"",_245,3,2,3,0,3
,"",_289,3,1,3,0,3
,"",_294,3,2,3,0,3
,"",_302,3,2,3,0,3
,"",_319,3,2,3,0,3
,"",_360,3,1,2,0,2
,"",_367,3,1,3,0,3
,"",_377,3,1,3,0,3
,"",_392,3,2,3,0,3
,"",_32,2,2,2,0,2
,"",_51,2,2,2,0,2
,"",_56,2,2,1,0,1
,"",_60,2,1,0,0,0
,"",_67,2,2,1,0,1
,"",_73,2,3,2,0,2
,"",_74,2,2,1,0,1
,"",_78,2,1,2,0,2
,"",_88,2,2,2,0,2
,"",_91,2,2,1,0,1
,"",_95,2,1,2,0,2
,"",_101,2,2,1,0,1
,"",_106,2,2,2,0,2
,"",_107,2,2,2,0,2
,"",_108,2,2,0,2,2
,"",_109,2,1,1,0,1
,"",_115,2,1,2,0,2
,"",_116,2,1,0,0,0
,"",_117,2,2,2,0,2
,"",_119,2,2,1,1,2
,"",_120,2,2,2,0,2
,"",_124,2,2,2,0,2
,"",_125,2,2,1,0,1
,"",_128,2,2,2,0,2
,"",_133,2,1,2,0,2
,"",_138,2,2,2,0,2
,"",_142,2,3,0,2,2
,"",_156,2,2,2,0,2
,"",_157,2,1,2,0,2
,"",_159,2,1,1,0,1
,"",_160,2,1,0,0,0
,"",_161,2,1,2,0,2
,"",_165,2,1,2,0,2
,"",_172,2,2,2,0,2
,"",_173,2,2,2,0,2
,"",_175,2,2,2,0,2
,"",_177,2,2,2,0,2
,"",_178,2,2,2,0,2
,"",_179,2,1,2,0,2
,"",_181,2,1,2,0,2
,"",_184,2,1,0,0,0
,"",_186,2,2,1,0,1
,"",_187,2,2,2,0,2
,"",_194,2,2,2,0,2
,"",_195,2,2,2,0,2
,"",_197,2,2,1,1,2
,"",_198,2,2,2,0,2
,"",_199,2,2,2,0,2
,"",_200,2,2,2,0,2
,"",_201,2,2,0,1,1
,"",_202,2,2,2,0,2
,"",_204,2,2,0,0,0
,"",_214,2,1,2,0,2
,"",_217,2,2,2,0,2
,"",_219,2,1,2,0,2
,"",_228,2,1,2,0,2
,"",_235,2,1,2,0,2
,"",_241,2,2,1,0,1
,"",_242,2,2,0,1,1
,"",_248,2,2,2,0,2
,"",_251,2,1,2,0,2
,"",_252,2,2,2,0,2
,"",_254,2,1,2,0,2
,"",_257,2,2,2,0,2
,"",_259,2,2,0,0,0
,"",_260,2,2,1,0,1
,"",_261,2,2,2,0,2
,"",_270,2,2,2,0,2
,"",_275,2,1,2,0,2
,"",_276,2,2,1,0,1
,"",_279,2,2,2,0,2
,"",_280,2,1,2,0,2
,"",_281,2,2,2,0,2
,"",_286,2,2,0,2,2
,"",_291,2,1,2,0,2
,"",_296,2,2,2,0,2
,"",_297,2,1,2,0,2
,"",_299,2,1,2,0,2
,"",_303,2,2,2,0,2
,"",_304,2,2,2,0,2
,"",_305,2,2,2,0,2
,"",_306,2,1,2,0,2
,"",_307,2,2,2,0,2
,"",_308,2,2,2,0,2
,"",_309,2,2,2,0,2
,"",_310,2,2,2,0,2
,"",_313,2,2,2,0,2
,"",_315,2,2,0,0,0
,"",_324,2,2,2,0,2
,"",_325,2,2,2,0,2
,"",_330,2,2,2,0,2
,"",_337,2,1,2,0,2
,"",_338,2,2,1,0,1
,"",_341,2,2,2,0,2
,"",_344,2,1,2,0,2
,"",_348,2,2,2,0,2
,"",_351,2,2,2,0,2
,"",_356,2,1,2,0,2
,"",_366,2,1,2,0,2
,"",_373,2,1,1,0,1
,"",_376,2,1,2,0,2
,"",_378,2,1,2,0,2
,"",_379,2,1,2,0,2
,"",_388,2,2,2,0,2
,"",_391,2,1,2,0,2
,"",_396,2,2,2,0,2
,"",_401,2,1,2,0,2
,"",_403,2,2,2,0,2
,"",_404,2,2,2,0,2
,"",_405,2,2,2,0,2
,"",_427,2,1,2,0,2
,"",_459,2,1,2,0,2
,"",_496,2,1,2,0,2
,"",_563,2,1,2,0,2
,"",_586,2,1,2,0,2
,"",_587,2,1,1,0,1
,"",_625,2,1,2,0,2
,"",_640,2,1,2,0,2
,"",_705,2,1,2,0,2
,"",_740,2,1,2,0,2
,"",_771,2,1,2,0,2
,"",_773,2,1,2,0,2
,"",_796,2,1,2,0,2
,"",_827,2,1,2,0,2
,"",_864,2,1,2,0,2
,"",_880,2,1,2,0,2
,"",_892,2,1,1,1,2
,"",_931,2,1,1,0,1
,"",_1177,2,1,2,0,2
,"",_42,1,1,1,0,1
,"",_79,1,1,1,0,1
,"",_82,1,1,1,0,1
,"",_84,1,1,1,0,1
,"",_97,1,1,1,0,1
,"",_98,1,1,1,0,1
,"",_99,1,1,1,0,1
,"",_110,1,1,0,0,0
,"",_114,1,1,1,0,1
,"",_118,1,1,1,0,1
,"",_126,1,1,1,0,1
,"",_127,1,1,1,0,1
,"",_129,1,1,0,0,0
,"",_131,1,1,1,0,1
,"",_132,1,1,1,0,1
,"",_134,1,1,1,0,1
,"",_139,1,1,1,0,1
,"",_140,1,1,1,0,1
,"",_141,1,1,1,0,1
,"",_143,1,1,1,0,1
,"",_144,1,1,1,0,1
,"",_146,1,1,1,0,1
,"",_147,1,1,0,0,0
,"",_149,1,1,0,0,0
,"",_150,1,1,1,0,1
,"",_152,1,1,1,0,1
,"",_153,1,1,1,0,1
,"",_155,1,1,1,0,1
,"",_162,1,1,1,0,1
,"",_164,1,1,1,0,1
,"",_168,1,1,0,1,1
,"",_171,1,1,1,0,1
,"",_174,1,1,0,0,0
,"",_176,1,1,1,0,1
,"",_180,1,1,1,0,1
,"",_182,1,1,1,0,1
,"",_183,1,1,0,0,0
,"",_185,1,1,1,0,1
,"",_188,1,1,1,0,1
,"",_189,1,1,1,0,1
,"",_190,1,1,1,0,1
,"",_191,1,1,0,0,0
,"",_192,1,1,1,0,1
,"",_193,1,1,1,0,1
,"",_196,1,1,1,0,1
,"",_203,1,1,1,0,1
,"",_205,1,1,1,0,1
,"",_206,1,1,1,0,1
,"",_207,1,1,1,0,1
,"",_208,1,1,1,0,1
,"",_209,1,1,1,0,1
,"",_210,1,1,0,0,0
,"",_211,1,1,1,0,1
,"",_212,1,1,0,0,0
,"",_213,1,1,1,0,1
,"",_215,1,1,1,0,1
,"",_216,1,1,1,0,1
,"",_218,1,1,1,0,1
,"",_220,1,1,1,0,1
,"",_221,1,1,1,0,1
,"",_222,1,1,1,0,1
,"",_223,1,1,1,0,1
,"",_224,1,1,1,0,1
,"",_225,1,1,1,0,1
,"",_226,1,1,1,0,1
,"",_227,1,1,1,0,1
,"",_229,1,1,1,0,1
,"",_230,1,1,1,0,1
,"",_231,1,1,1,0,1
,"",_232,1,1,0,0,0
,"",_233,1,1,1,0,1
,"",_234,1,1,1,0,1
,"",_236,1,1,1,0,1
,"",_237,1,1,1,0,1
,"",_238,1,1,1,0,1
,"",_239,1,1,1,0,1
,"",_240,1,1,1,0,1
,"",_243,1,1,1,0,1
,"",_244,1,1,1,0,1
,"",_246,1,1,1,0,1
,"",_247,1,1,1,0,1
,"",_249,1,1,1,0,1
,"",_250,1,1,0,0,0
,"",_253,1,1,1,0,1
,"",_255,1,1,1,0,1
,"",_256,1,1,1,0,1
,"",_258,1,1,1,0,1
,"",_262,1,1,1,0,1
,"",_263,1,1,1,0,1
,"",_264,1,1,1,0,1
,"",_265,1,1,1,0,1
,"",_266,1,1,1,0,1
,"",_267,1,1,1,0,1
,"",_268,1,1,1,0,1
,"",_269,1,1,1,0,1
,"",_271,1,1,1,0,1
,"",_272,1,1,0,0,0
,"",_273,1,1,1,0,1
,"",_274,1,1,1,0,1
,"",_277,1,1,1,0,1
,"",_278,1,1,0,1,1
,"",_282,1,1,1,0,1
,"",_283,1,1,1,0,1
,"",_284,1,1,1,0,1
,"",_285,1,1,1,0,1
,"",_287,1,1,1,0,1
,"",_288,1,1,0,0,0
,"",_290,1,1,1,0,1
,"",_292,1,1,1,0,1
,"",_293,1,1,1,0,1
,"",_295,1,1,1,0,1
,"",_298,1,1,1,0,1
,"",_300,1,1,1,0,1
,"",_301,1,1,1,0,1
,"",_311,1,1,0,1,1
,"",_312,1,1,1,0,1
,"",_314,1,1,1,0,1
,"",_316,1,1,1,0,1
,"",_317,1,1,1,0,1
,"",_318,1,1,0,0,0
,"",_320,1,1,1,0,1
,"",_321,1,1,0,0,0
,"",_322,1,1,1,0,1
,"",_323,1,1,1,0,1
,"",_326,1,1,1,0,1
,"",_327,1,1,1,0,1
,"",_328,1,1,1,0,1
,"",_329,1,1,0,0,0
,"",_331,1,1,1,0,1
,"",_332,1,1,1,0,1
,"",_333,1,1,1,0,1
,"",_334,1,1,1,0,1
,"",_335,1,1,0,1,1
,"",_336,1,1,1,0,1
,"",_339,1,1,0,0,0
,"",_340,1,1,1,0,1
,"",_342,1,1,1,0,1
,"",_343,1,1,1,0,1
,"",_345,1,1,1,0,1
,"",_346,1,1,1,0,1
,"",_347,1,1,1,0,1
,"",_349,1,1,1,0,1
,"",_350,1,1,1,0,1
,"",_352,1,1,1,0,1
,"",_353,1,1,1,0,1
,"",_354,1,1,1,0,1
,"",_355,1,1,1,0,1
,"",_357,1,1,1,0,1
,"",_358,1,1,1,0,1
,"",_359,1,1,1,0,1
,"",_361,1,1,1,0,1
,"",_362,1,1,0,0,0
,"",_363,1,1,1,0,1
,"",_364,1,1,0,0,0
,"",_365,1,1,1,0,1
,"",_368,1,1,1,0,1
,"",_369,1,1,1,0,1
,"",_370,1,1,1,0,1
,"",_371,1,1,1,0,1
,"",_372,1,1,1,0,1
,"",_374,1,1,1,0,1
,"",_375,1,1,1,0,1
,"",_380,1,1,1,0,1
,"",_381,1,1,0,0,0
,"",_382,1,1,1,0,1
,"",_383,1,1,1,0,1
,"",_384,1,1,1,0,1
,"",_385,1,1,0,1,1
,"",_386,1,1,1,0,1
,"",_387,1,1,1,0,1
,"",_389,1,1,1,0,1
,"",_390,1,1,1,0,1
,"",_393,1,1,1,0,1
,"",_394,1,1,1,0,1
,"",_395,1,1,1,0,1
,"",_397,1,1,1,0,1
,"",_398,1,1,1,0,1
,"",_399,1,1,1,0,1
,"",_400,1,1,1,0,1
,"",_402,1,1,1,0,1
,"",_406,1,1,1,0,1
,"",_407,1,1,1,0,1
,"",_408,1,1,1,0,1
,"",_409,1,1,1,0,1
,"",_410,1,1,1,0,1
,"",_411,1,1,1,0,1
,"",_412,1,1,1,0,1
,"",_413,1,1,1,0,1
,"",_414,1,1,1,0,1
,"",_415,1,1,0,0,0
,"",_416,1,1,1,0,1
,"",_417,1,1,1,0,1
,"",_418,1,1,1,0,1
,"",_419,1,1,1,0,1
,"",_420,1,1,1,0,1
,"",_421,1,1,1,0,1
,"",_422,1,1,0,1,1
,"",_423,1,1,0,0,0
,"",_424,1,1,1,0,1
,"",_425,1,1,1,0,1
,"",_426,1,1,1,0,1
,"",_428,1,1,1,0,1
,"",_429,1,1,1,0,1
,"",_430,1,1,1,0,1
,"",_431,1,1,1,0,1
,"",_432,1,1,1,0,1
,"",_433,1,1,1,0,1
,"",_434,1,1,1,0,1
,"",_435,1,1,1,0,1
,"",_436,1,1,1,0,1
,"",_437,1,1,1,0,1
,"",_438,1,1,1,0,1
,"",_439,1,1,1,0,1
,"",_440,1,1,1,0,1
,"",_441,1,1,1,0,1
,"",_442,1,1,1,0,1
,"",_443,1,1,1,0,1
,"",_444,1,1,1,0,1
,"",_445,1,1,1,0,1
,"",_446,1,1,1,0,1
,"",_447,1,1,0,1,1
,"",_448,1,1,1,0,1
,"",_449,1,1,1,0,1
,"",_450,1,1,1,0,1
,"",_451,1,1,1,0,1
,"",_452,1,1,1,0,1
,"",_453,1,1,1,0,1
,"",_454,1,1,1,0,1
,"",_455,1,1,1,0,1
,"",_456,1,1,1,0,1
,"",_457,1,1,1,0,1
,"",_458,1,1,1,0,1
,"",_460,1,1,1,0,1
,"",_461,1,1,0,0,0
,"",_462,1,1,1,0,1
,"",_463,1,1,1,0,1
,"",_464,1,1,1,0,1
,"",_465,1,1,1,0,1
,"",_466,1,1,1,0,1
,"",_467,1,1,0,0,0
,"",_468,1,1,1,0,1
,"",_469,1,1,1,0,1
,"",_470,1,1,1,0,1
,"",_471,1,1,1,0,1
,"",_472,1,1,1,0,1
,"",_473,1,1,1,0,1
,"",_474,1,1,1,0,1
,"",_475,1,1,0,1,1
,"",_476,1,1,1,0,1
,"",_477,1,1,1,0,1
,"",_478,1,1,1,0,1
,"",_479,1,1,1,0,1
,"",_480,1,1,1,0,1
,"",_481,1,1,1,0,1
,"",_482,1,1,1,0,1
,"",_483,1,1,1,0,1
,"",_484,1,1,1,0,1
,"",_485,1,1,0,1,1
,"",_486,1,1,1,0,1
,"",_487,1,1,1,0,1
,"",_488,1,1,1,0,1
,"",_489,1,1,1,0,1
,"",_490,1,1,1,0,1
,"",_491,1,1,1,0,1
,"",_492,1,1,1,0,1
,"",_493,1,1,1,0,1
,"",_494,1,1,1,0,1
,"",_495,1,1,1,0,1
,"",_497,1,1,1,0,1
,"",_498,1,1,1,0,1
,"",_499,1,1,1,0,1
,"",_500,1,1,1,0,1
,"",_501,1,1,1,0,1
,"",_502,1,1,1,0,1
,"",_503,1,1,1,0,1
,"",_504,1,1,1,0,1
,"",_505,1,1,1,0,1
,"",_506,1,1,1,0,1
,"",_507,1,1,1,0,1
,"",_508,1,1,1,0,1
,"",_509,1,1,1,0,1
,"",_510,1,1,1,0,1
,"",_511,1,1,1,0,1
,"",_512,1,1,1,0,1
,"",_513,1,1,1,0,1
,"",_514,1,1,1,0,1
,"",_515,1,1,1,0,1
,"",_516,1,1,0,0,0
,"",_517,1,1,1,0,1
,"",_518,1,1,1,0,1
,"",_519,1,1,0,0,0
,"",_520,1,1,0,0,0
,"",_521,1,1,1,0,1
,"",_522,1,1,1,0,1
,"",_523,1,1,1,0,1
,"",_524,1,1,0,0,0
,"",_525,1,1,1,0,1
,"",_526,1,1,1,0,1
,"",_527,1,1,1,0,1
,"",_528,1,1,0,1,1
,"",_529,1,1,0,0,0
,"",_530,1,1,1,0,1
,"",_531,1,1,1,0,1
,"",_532,1,1,1,0,1
,"",_533,1,1,1,0,1
,"",_534,1,1,1,0,1
,"",_535,1,1,1,0,1
,"",_536,1,1,1,0,1
,"",_537,1,1,1,0,1
,"",_538,1,1,1,0,1
,"",_539,1,1,1,0,1
,"",_540,1,1,1,0,1
,"",_541,1,1,1,0,1
,"",_542,1,1,1,0,1
,"",_543,1,1,1,0,1
,"",_544,1,1,1,0,1
,"",_545,1,1,1,0,1
,"",_546,1,1,1,0,1
,"",_547,1,1,1,0,1
,"",_548,1,1,1,0,1
,"",_549,1,1,1,0,1
,"",_550,1,1,1,0,1
,"",_551,1,1,1,0,1
,"",_552,1,1,1,0,1
,"",_553,1,1,1,0,1
,"",_554,1,1,1,0,1
,"",_555,1,1,1,0,1
,"",_556,1,1,1,0,1
,"",_557,1,1,0,0,0
,"",_558,1,1,1,0,1
,"",_559,1,1,1,0,1
,"",_560,1,1,1,0,1
,"",_561,1,1,1,0,1
,"",_562,1,1,1,0,1
,"",_564,1,1,1,0,1
,"",_565,1,1,0,0,0
,"",_566,1,1,1,0,1
,"",_567,1,1,1,0,1
,"",_568,1,1,1,0,1
,"",_569,1,1,1,0,1
,"",_570,1,1,1,0,1
,"",_571,1,1,1,0,1
,"",_572,1,1,1,0,1
,"",_573,1,1,1,0,1
,"",_574,1,1,1,0,1
,"",_575,1,1,1,0,1
,"",_576,1,1,1,0,1
,"",_577,1,1,1,0,1
,"",_578,1,1,1,0,1
,"",_579,1,1,1,0,1
,"",_580,1,1,1,0,1
,"",_581,1,1,1,0,1
,"",_582,1,1,1,0,1
,"",_583,1,1,1,0,1
,"",_584,1,1,1,0,1
,"",_585,1,1,1,0,1
,"",_588,1,1,1,0,1
,"",_589,1,1,1,0,1
,"",_590,1,1,1,0,1
,"",_591,1,1,1,0,1
,"",_592,1,1,1,0,1
,"",_593,1,1,1,0,1
,"",_594,1,1,1,0,1
,"",_595,1,1,1,0,1
,"",_596,1,1,1,0,1
,"",_597,1,1,1,0,1
,"",_598,1,1,0,1,1
,"",_599,1,1,1,0,1
,"",_600,1,1,1,0,1
,"",_601,1,1,1,0,1
,"",_602,1,1,1,0,1
,"",_603,1,1,1,0,1
,"",_604,1,1,1,0,1
,"",_605,1,1,1,0,1
,"",_606,1,1,1,0,1
,"",_607,1,1,1,0,1
,"",_608,1,1,1,0,1
,"",_609,1,1,1,0,1
,"",_610,1,1,1,0,1
,"",_611,1,1,1,0,1
,"",_612,1,1,1,0,1
,"",_613,1,1,1,0,1
,"",_614,1,1,0,0,0
,"",_615,1,1,1,0,1
,"",_616,1,1,1,0,1
,"",_617,1,1,1,0,1
,"",_618,1,1,1,0,1
,"",_619,1,1,0,0,0
,"",_620,1,1,1,0,1
,"",_621,1,1,1,0,1
,"",_622,1,1,1,0,1
,"",_623,1,1,1,0,1
,"",_624,1,1,1,0,1
,"",_626,1,1,1,0,1
,"",_627,1,1,1,0,1
,"",_628,1,1,1,0,1
,"",_629,1,1,1,0,1
,"",_630,1,1,1,0,1
,"",_631,1,1,1,0,1
,"",_632,1,1,1,0,1
,"",_633,1,1,1,0,1
,"",_634,1,1,0,0,0
,"",_635,1,1,0,0,0
,"",_636,1,1,1,0,1
,"",_637,1,1,1,0,1
,"",_638,1,1,1,0,1
,"",_639,1,1,1,0,1
,"",_641,1,1,1,0,1
,"",_642,1,1,1,0,1
,"",_643,1,1,1,0,1
,"",_644,1,1,1,0,1
,"",_645,1,1,1,0,1
,"",_646,1,1,1,0,1
,"",_647,1,1,0,0,0
,"",_648,1,1,1,0,1
,"",_649,1,1,1,0,1
,"",_650,1,1,1,0,1
,"",_651,1,1,1,0,1
,"",_652,1,1,0,0,0
,"",_653,1,1,1,0,1
,"",_654,1,1,1,0,1
,"",_655,1,1,1,0,1
,"",_656,1,1,1,0,1
,"",_657,1,1,1,0,1
,"",_658,1,1,1,0,1
,"",_659,1,1,1,0,1
,"",_660,1,1,0,0,0
,"",_661,1,1,1,0,1
,"",_662,1,1,1,0,1
,"",_663,1,1,0,0,0
,"",_664,1,1,0,0,0
,"",_665,1,1,1,0,1
,"",_666,1,1,1,0,1
,"",_667,1,1,1,0,1
,"",_668,1,1,1,0,1
,"",_669,1,1,0,1,1
,"",_670,1,1,1,0,1
,"",_671,1,1,1,0,1
,"",_672,1,1,1,0,1
,"",_673,1,1,1,0,1
,"",_674,1,1,1,0,1
,"",_675,1,1,1,0,1
,"",_676,1,1,1,0,1
,"",_677,1,1,0,1,1
,"",_678,1,1,1,0,1
,"",_679,1,1,1,0,1
,"",_680,1,1,1,0,1
,"",_681,1,1,1,0,1
,"",_682,1,1,1,0,1
,"",_683,1,1,1,0,1
,"",_684,1,1,1,0,1
,"",_685,1,1,0,0,0
,"",_686,1,1,1,0,1
,"",_687,1,1,1,0,1
,"",_688,1,1,1,0,1
,"",_689,1,1,1,0,1
,"",_690,1,1,1,0,1
,"",_691,1,1,1,0,1
,"",_692,1,1,1,0,1
,"",_693,1,1,1,0,1
,"",_694,1,1,1,0,1
,"",_695,1,1,1,0,1
,"",_696,1,1,1,0,1
,"",_697,1,1,1,0,1
,"",_698,1,1,1,0,1
,"",_699,1,1,1,0,1
,"",_700,1,1,1,0,1
,"",_701,1,1,1,0,1
,"",_702,1,1,1,0,1
,"",_703,1,1,1,0,1
,"",_704,1,1,1,0,1
,"",_706,1,1,0,0,0
,"",_707,1,1,1,0,1
,"",_708,1,1,1,0,1
,"",_709,1,1,1,0,1
,"",_710,1,1,1,0,1
,"",_711,1,1,1,0,1
,"",_712,1,1,1,0,1
,"",_713,1,1,1,0,1
,"",_714,1,1,1,0,1
,"",_715,1,1,1,0,1
,"",_716,1,1,1,0,1
,"",_717,1,1,1,0,1
,"",_718,1,1,1,0,1
,"",_719,1,1,1,0,1
,"",_720,1,1,1,0,1
,"",_721,1,1,1,0,1
,"",_722,1,1,1,0,1
,"",_723,1,1,1,0,1
,"",_724,1,1,1,0,1
,"",_725,1,1,1,0,1
,"",_726,1,1,1,0,1
,"",_727,1,1,1,0,1
,"",_728,1,1,1,0,1
,"",_729,1,1,1,0,1
,"",_730,1,1,1,0,1
,"",_731,1,1,1,0,1
,"",_732,1,1,1,0,1
,"",_733,1,1,1,0,1
,"",_734,1,1,0,1,1
,"",_735,1,1,0,0,0
,"",_736,1,1,1,0,1
,"",_737,1,1,1,0,1
,"",_738,1,1,1,0,1
,"",_739,1,1,1,0,1
,"",_741,1,1,1,0,1
,"",_742,1,1,1,0,1
,"",_743,1,1,0,0,0
,"",_744,1,1,1,0,1
,"",_745,1,1,1,0,1
,"",_746,1,1,1,0,1
,"",_747,1,1,1,0,1
,"",_748,1,1,1,0,1
,"",_749,1,1,1,0,1
,"",_750,1,1,1,0,1
,"",_751,1,1,1,0,1
,"",_752,1,1,1,0,1
,"",_753,1,1,1,0,1
,"",_754,1,1,1,0,1
,"",_755,1,1,1,0,1
,"",_756,1,1,1,0,1
,"",_757,1,1,1,0,1
,"",_758,1,1,1,0,1
,"",_759,1,1,1,0,1
,"",_760,1,1,0,0,0
,"",_761,1,1,1,0,1
,"",_762,1,1,0,0,0
,"",_763,1,1,1,0,1
,"",_764,1,1,1,0,1
,"",_765,1,1,1,0,1
,"",_766,1,1,1,0,1
,"",_767,1,1,1,0,1
,"",_768,1,1,1,0,1
,"",_769,1,1,1,0,1
,"",_770,1,1,1,0,1
,"",_772,1,1,0,0,0
,"",_774,1,1,1,0,1
,"",_775,1,1,1,0,1
,"",_776,1,1,1,0,1
,"",_777,1,1,1,0,1
,"",_778,1,1,1,0,1
,"",_779,1,1,1,0,1
,"",_780,1,1,1,0,1
,"",_781,1,1,1,0,1
,"",_782,1,1,1,0,1
,"",_783,1,1,1,0,1
,"",_784,1,1,1,0,1
,"",_785,1,1,1,0,1
,"",_786,1,1,1,0,1
,"",_787,1,1,1,0,1
,"",_788,1,1,1,0,1
,"",_789,1,1,1,0,1
,"",_790,1,1,1,0,1
,"",_791,1,1,1,0,1
,"",_792,1,1,1,0,1
,"",_793,1,1,1,0,1
,"",_794,1,1,1,0,1
,"",_795,1,1,1,0,1
,"",_797,1,1,1,0,1
,"",_798,1,1,1,0,1
,"",_799,1,1,1,0,1
,"",_800,1,1,1,0,1
,"",_801,1,1,1,0,1
,"",_802,1,1,1,0,1
,"",_803,1,1,1,0,1
,"",_804,1,1,1,0,1
,"",_805,1,1,1,0,1
,"",_806,1,1,1,0,1
,"",_807,1,1,1,0,1
,"",_808,1,1,1,0,1
,"",_809,1,1,1,0,1
,"",_810,1,1,1,0,1
,"",_811,1,1,1,0,1
,"",_812,1,1,1,0,1
,"",_813,1,1,1,0,1
,"",_814,1,1,0,0,0
,"",_815,1,1,1,0,1
,"",_816,1,1,1,0,1
,"",_817,1,1,1,0,1
,"",_818,1,1,1,0,1
,"",_819,1,1,1,0,1
,"",_820,1,1,1,0,1
,"",_821,1,1,1,0,1
,"",_822,1,1,1,0,1
,"",_823,1,1,1,0,1
,"",_824,1,1,1,0,1
,"",_825,1,1,1,0,1
,"",_826,1,1,1,0,1
,"",_828,1,1,1,0,1
,"",_829,1,1,1,0,1
,"",_830,1,1,1,0,1
,"",_831,1,1,1,0,1
,"",_832,1,1,1,0,1
,"",_833,1,1,1,0,1
,"",_834,1,1,0,0,0
,"",_835,1,1,1,0,1
,"",_836,1,1,1,0,1
,"",_837,1,1,1,0,1
,"",_838,1,1,1,0,1
,"",_839,1,1,0,0,0
,"",_840,1,1,1,0,1
,"",_841,1,1,1,0,1
,"",_842,1,1,1,0,1
,"",_843,1,1,1,0,1
,"",_844,1,1,1,0,1
,"",_845,1,1,1,0,1
,"",_846,1,1,1,0,1
,"",_847,1,1,1,0,1
,"",_848,1,1,1,0,1
,"",_849,1,1,1,0,1
,"",_850,1,1,1,0,1
,"",_851,1,1,1,0,1
,"",_852,1,1,0,0,0
,"",_853,1,1,1,0,1
,"",_854,1,1,1,0,1
,"",_855,1,1,1,0,1
,"",_856,1,1,1,0,1
,"",_857,1,1,1,0,1
,"",_858,1,1,1,0,1
,"",_859,1,1,1,0,1
,"",_860,1,1,1,0,1
,"",_861,1,1,1,0,1
,"",_862,1,1,1,0,1
,"",_863,1,1,1,0,1
,"",_865,1,1,1,0,1
,"",_866,1,1,1,0,1
,"",_867,1,1,1,0,1
,"",_868,1,1,1,0,1
,"",_869,1,1,1,0,1
,"",_870,1,1,1,0,1
,"",_871,1,1,1,0,1
,"",_872,1,1,1,0,1
,"",_873,1,1,1,0,1
,"",_874,1,1,1,0,1
,"",_875,1,1,1,0,1
,"",_876,1,1,1,0,1
,"",_877,1,1,1,0,1
,"",_878,1,1,1,0,1
,"",_879,1,1,1,0,1
,"",_881,1,1,1,0,1
,"",_882,1,1,1,0,1
,"",_883,1,1,1,0,1
,"",_884,1,1,1,0,1
,"",_885,1,1,0,0,0
,"",_886,1,1,1,0,1
,"",_887,1,1,1,0,1
,"",_888,1,1,1,0,1
,"",_889,1,1,1,0,1
,"",_890,1,1,1,0,1
,"",_891,1,1,1,0,1
,"",_893,1,1,1,0,1
,"",_894,1,1,1,0,1
,"",_895,1,1,1,0,1
,"",_896,1,1,1,0,1
,"",_897,1,1,1,0,1
,"",_898,1,1,0,0,0
,"",_899,1,1,1,0,1
,"",_900,1,1,1,0,1
,"",_901,1,1,0,0,0
,"",_902,1,1,1,0,1
,"",_903,1,1,1,0,1
,"",_904,1,1,1,0,1
,"",_905,1,1,1,0,1
,"",_906,1,1,1,0,1
,"",_907,1,1,1,0,1
,"",_908,1,1,1,0,1
,"",_909,1,1,1,0,1
,"",_910,1,1,1,0,1
,"",_911,1,1,1,0,1
,"",_912,1,1,1,0,1
,"",_913,1,1,1,0,1
,"",_914,1,1,1,0,1
,"",_915,1,1,1,0,1
,"",_916,1,1,1,0,1
,"",_917,1,1,1,0,1
,"",_918,1,1,1,0,1
,"",_919,1,1,1,0,1
,"",_920,1,1,1,0,1
,"",_921,1,1,1,0,1
,"",_922,1,1,1,0,1
,"",_923,1,1,1,0,1
,"",_924,1,1,1,0,1
,"",_925,1,1,1,0,1
,"",_926,1,1,1,0,1
,"",_927,1,1,1,0,1
,"",_928,1,1,1,0,1
,"",_929,1,1,1,0,1
,"",_930,1,1,1,0,1
,"",_932,1,1,1,0,1
,"",_933,1,1,1,0,1
,"",_934,1,1,0,0,0
,"",_935,1,1,1,0,1
,"",_936,1,1,1,0,1
,"",_937,1,1,0,0,0
,"",_938,1,1,1,0,1
,"",_939,1,1,1,0,1
,"",_940,1,1,1,0,1
,"",_941,1,1,1,0,1
,"",_942,1,1,1,0,1
,"",_943,1,1,1,0,1
,"",_944,1,1,1,0,1
,"",_945,1,1,1,0,1
,"",_946,1,1,1,0,1
,"",_947,1,1,1,0,1
,"",_948,1,1,1,0,1
,"",_949,1,1,1,0,1
,"",_950,1,1,1,0,1
,"",_951,1,1,1,0,1
,"",_952,1,1,0,0,0
,"",_953,1,1,1,0,1
,"",_954,1,1,0,1,1
,"",_955,1,1,0,0,0
,"",_956,1,1,0,0,0
,"",_957,1,1,1,0,1
,"",_958,1,1,0,0,0
,"",_959,1,1,0,0,0
,"",_960,1,1,0,0,0
,"",_961,1,1,0,1,1
,"",_962,1,1,1,0,1
,"",_963,1,1,1,0,1
,"",_964,1,1,1,0,1
,"",_965,1,1,1,0,1
,"",_966,1,1,1,0,1
,"",_967,1,1,1,0,1
,"",_968,1,1,1,0,1
,"",_969,1,1,0,0,0
,"",_970,1,1,1,0,1
,"",_971,1,1,1,0,1
,"",_972,1,1,1,0,1
,"",_973,1,1,0,1,1
,"",_974,1,1,1,0,1
,"",_975,1,1,0,0,0
,"",_976,1,1,1,0,1
,"",_977,1,1,1,0,1
,"",_978,1,1,1,0,1
,"",_979,1,1,1,0,1
,"",_980,1,1,1,0,1
,"",_981,1,1,1,0,1
,"",_982,1,1,1,0,1
,"",_983,1,1,0,1,1
,"",_984,1,1,1,0,1
,"",_985,1,1,1,0,1
,"",_986,1,1,1,0,1
,"",_987,1,1,1,0,1
,"",_988,1,1,1,0,1
,"",_989,1,1,1,0,1
,"",_990,1,1,1,0,1
,"",_991,1,1,1,0,1
,"",_992,1,1,1,0,1
,"",_993,1,1,1,0,1
,"",_994,1,1,1,0,1
,"",_995,1,1,1,0,1
,"",_996,1,1,1,0,1
,"",_997,1,1,1,0,1
,"",_998,1,1,0,0,0
,"",_999,1,1,1,0,1
,"",_1000,1,1,1,0,1
,"",_1001,1,1,0,0,0
,"",_1002,1,1,1,0,1
,"",_1003,1,1,1,0,1
,"",_1004,1,1,1,0,1
,"",_1005,1,1,1,0,1
,"",_1006,1,1,1,0,1
,"",_1007,1,1,1,0,1
,"",_1008,1,1,1,0,1
,"",_1009,1,1,1,0,1
,"",_1010,1,1,1,0,1
,"",_1011,1,1,1,0,1
,"",_1012,1,1,1,0,1
,"",_1013,1,1,1,0,1
,"",_1014,1,1,1,0,1
,"",_1015,1,1,1,0,1
,"",_1016,1,1,1,0,1
,"",_1017,1,1,1,0,1
,"",_1018,1,1,1,0,1
,"",_1019,1,1,1,0,1
,"",_1020,1,1,1,0,1
,"",_1021,1,1,1,0,1
,"",_1022,1,1,1,0,1
,"",_1023,1,1,1,0,1
,"",_1024,1,1,1,0,1
,"",_1025,1,1,1,0,1
,"",_1026,1,1,0,0,0
,"",_1027,1,1,1,0,1
,"",_1028,1,1,1,0,1
,"",_1029,1,1,0,0,0
,"",_1030,1,1,1,0,1
,"",_1031,1,1,1,0,1
,"",_1032,1,1,1,0,1
,"",_1033,1,1,1,0,1
,"",_1034,1,1,1,0,1
,"",_1035,1,1,1,0,1
,"",_1036,1,1,1,0,1
,"",_1037,1,1,0,0,0
,"",_1038,1,1,1,0,1
,"",_1039,1,1,1,0,1
,"",_1040,1,1,0,0,0
,"",_1041,1,1,1,0,1
,"",_1042,1,1,1,0,1
,"",_1043,1,1,1,0,1
,"",_1044,1,1,1,0,1
,"",_1045,1,1,1,0,1
,"",_1046,1,1,1,0,1
,"",_1047,1,1,1,0,1
,"",_1048,1,1,1,0,1
,"",_1049,1,1,1,0,1
,"",_1050,1,1,1,0,1
,"",_1051,1,1,1,0,1
,"",_1052,1,1,1,0,1
,"",_1053,1,1,1,0,1
,"",_1054,1,1,0,0,0
,"",_1055,1,1,1,0,1
,"",_1056,1,1,1,0,1
,"",_1057,1,1,1,0,1
,"",_1058,1,1,1,0,1
,"",_1059,1,1,1,0,1
,"",_1060,1,1,1,0,1
,"",_1061,1,1,1,0,1
,"",_1062,1,1,1,0,1
,"",_1063,1,1,1,0,1
,"",_1064,1,1,1,0,1
,"",_1065,1,1,1,0,1
,"",_1066,1,1,1,0,1
,"",_1067,1,1,1,0,1
,"",_1068,1,1,1,0,1
,"",_1069,1,1,1,0,1
,"",_1070,1,1,1,0,1
,"",_1071,1,1,1,0,1
,"",_1072,1,1,1,0,1
,"",_1073,1,1,1,0,1
,"",_1074,1,1,1,0,1
,"",_1075,1,1,1,0,1
,"",_1076,1,1,1,0,1
,"",_1077,1,1,1,0,1
,"",_1078,1,1,0,0,0
,"",_1079,1,1,1,0,1
,"",_1080,1,1,1,0,1
,"",_1081,1,1,1,0,1
,"",_1082,1,1,1,0,1
,"",_1083,1,1,1,0,1
,"",_1084,1,1,1,0,1
,"",_1085,1,1,1,0,1
,"",_1086,1,1,1,0,1
,"",_1087,1,1,0,1,1
,"",_1088,1,1,1,0,1
,"",_1089,1,1,1,0,1
,"",_1090,1,1,1,0,1
,"",_1091,1,1,0,1,1
,"",_1092,1,1,1,0,1
,"",_1093,1,1,1,0,1
,"",_1094,1,1,1,0,1
,"",_1095,1,1,1,0,1
,"",_1096,1,1,1,0,1
,"",_1097,1,1,1,0,1
,"",_1098,1,1,1,0,1
,"",_1099,1,1,1,0,1
,"",_1100,1,1,1,0,1
,"",_1101,1,1,0,0,0
,"",_1102,1,1,1,0,1
,"",_1103,1,1,1,0,1
,"",_1104,1,1,1,0,1
,"",_1105,1,1,1,0,1
,"",_1106,1,1,1,0,1
,"",_1107,1,1,1,0,1
,"",_1108,1,1,0,0,0
,"",_1109,1,1,1,0,1
,"",_1110,1,1,1,0,1
,"",_1111,1,1,1,0,1
,"",_1112,1,1,1,0,1
,"",_1113,1,1,1,0,1
,"",_1114,1,1,0,1,1
,"",_1115,1,1,1,0,1
,"",_1116,1,1,1,0,1
,"",_1117,1,1,1,0,1
,"",_1118,1,1,1,0,1
,"",_1119,1,1,1,0,1
,"",_1120,1,1,1,0,1
,"",_1121,1,1,1,0,1
,"",_1122,1,1,1,0,1
,"",_1123,1,1,1,0,1
,"",_1124,1,1,1,0,1
,"",_1125,1,1,1,0,1
,"",_1126,1,1,1,0,1
,"",_1127,1,1,1,0,1
,"",_1128,1,1,1,0,1
,"",_1129,1,1,1,0,1
,"",_1130,1,1,1,0,1
,"",_1131,1,1,1,0,1
,"",_1132,1,1,1,0,1
,"",_1133,1,1,1,0,1
,"",_1134,1,1,1,0,1
,"",_1135,1,1,1,0,1
,"",_1136,1,1,1,0,1
,"",_1137,1,1,1,0,1
,"",_1138,1,1,0,0,0
,"",_1139,1,1,1,0,1
,"",_1140,1,1,1,0,1
,"",_1141,1,1,1,0,1
,"",_1142,1,1,1,0,1
,"",_1143,1,1,1,0,1
,"",_1144,1,1,0,0,0
,"",_1145,1,1,1,0,1
,"",_1146,1,1,0,0,0
,"",_1147,1,1,1,0,1
,"",_1148,1,1,1,0,1
,"",_1149,1,1,1,0,1
,"",_1150,1,1,1,0,1
,"",_1151,1,1,1,0,1
,"",_1152,1,1,1,0,1
,"",_1153,1,1,1,0,1
,"",_1154,1,1,1,0,1
,"",_1155,1,1,0,0,0
,"",_1156,1,1,1,0,1
,"",_1157,1,1,1,0,1
,"",_1158,1,1,1,0,1
,"",_1159,1,1,1,0,1
,"",_1160,1,1,1,0,1
,"",_1161,1,1,1,0,1
,"",_1162,1,1,1,0,1
,"",_1163,1,1,1,0,1
,"",_1164,1,1,1,0,1
,"",_1165,1,1,1,0,1
,"",_1166,1,1,1,0,1
,"",_1167,1,1,1,0,1
,"",_1168,1,1,1,0,1
,"",_1169,1,1,1,0,1
,"",_1170,1,1,1,0,1
,"",_1171,1,1,1,0,1
,"",_1172,1,1,1,0,1
,"",_1173,1,1,1,0,1
,"",_1174,1,1,1,0,1
,"",_1175,1,1,1,0,1
,"",_1176,1,1,1,0,1
,"",_1178,1,1,1,0,1
,"",_1179,1,1,1,0,1
,"",_1180,1,1,1,0,1
,"",_1181,1,1,1,0,1
,"",_1182,1,1,1,0,1
,"",_1183,1,1,1,0,1
,"",_1184,1,1,1,0,1
,"",_1185,1,1,1,0,1
,"",_1186,1,1,1,0,1
,"",_1187,1,1,1,0,1
,"",_1188,1,1,1,0,1
,"",_1189,1,1,1,0,1
,"",_1190,1,1,1,0,1
,"",_1191,1,1,1,0,1
,"",_1192,1,1,1,0,1
,"",_1193,1,1,1,0,1
,"",_1194,1,1,0,0,0
,"",_1195,1,1,1,0,1
,"",_1196,1,1,1,0,1
,"",_1197,1,1,1,0,1
,"",_1198,1,1,1,0,1
,"",_1199,1,1,1,0,1
,"",_1200,1,1,1,0,1
,"",_1201,1,1,1,0,1
,"",_1202,1,1,0,1,1
,"",_1203,1,1,0,1,1
,"",_1204,1,1,1,0,1
,"",_1205,1,1,1,0,1
,"",_1206,1,1,1,0,1
,"",_1207,1,1,1,0,1
,"",_1208,1,1,1,0,1
,"",_1209,1,1,1,0,1
,"",_1210,1,1,1,0,1
,"",_1211,1,1,1,0,1
,"",_1212,1,1,1,0,1
,"",_1213,1,1,1,0,1
,"",_1214,1,1,1,0,1
,"",_1215,1,1,1,0,1
,"",_1216,1,1,1,0,1
,"",_1217,1,1,1,0,1
,"",_1218,1,1,1,0,1
,"",_1219,1,1,1,0,1
,"",_1220,1,1,1,0,1
,"",_1221,1,1,1,0,1
,"",_1222,1,1,1,0,1
,"",_1223,1,1,1,0,1
,"",_1224,1,1,1,0,1
,"",_1225,1,1,1,0,1
,"",_1226,1,1,1,0,1
,"",_1227,1,1,0,0,0
,"",_1228,1,1,1,0,1
,"",_1229,1,1,1,0,1
,"",_1230,1,1,1,0,1
,"",_1231,1,1,1,0,1
,"",_1232,1,1,1,0,1
,"",_1233,1,1,1,0,1
,"",_1234,1,1,1,0,1
,"",_1235,1,1,1,0,1
,"",_1236,1,1,1,0,1
,"",_1237,1,1,1,0,1
,"",_1238,1,1,1,0,1
,"",_1239,1,1,1,0,1
,"",_1240,1,1,1,0,1
,"",_1241,1,1,1,0,1
,"",_1242,1,1,1,0,1
,"",_1243,1,1,1,0,1
,"",_1244,1,1,1,0,1
,"",_1245,1,1,1,0,1
,"",_1246,1,1,1,0,1
,"",_1247,1,1,1,0,1
,"",_1248,1,1,1,0,1
,"",_1249,1,1,1,0,1
,"",_1250,1,1,1,0,1
,"",_1251,1,1,1,0,1
,"",_1252,1,1,1,0,1
,"",_1253,1,1,1,0,1
,"",_1254,1,1,1,0,1
,"",_1255,1,1,0,0,0
,"",_1256,1,1,1,0,1
,"",_1257,1,1,1,0,1
,"",_1258,1,1,1,0,1
,"",_1259,1,1,1,0,1
,"",_1260,1,1,1,0,1
,"",_1261,1,1,1,0,1
,"",_1262,1,1,1,0,1
,"",_1263,1,1,1,0,1
,"",_1264,1,1,1,0,1
,"",_1265,1,1,1,0,1
,"",_1266,1,1,1,0,1
,"",_1267,1,1,1,0,1
,"",_1268,1,1,1,0,1
,"",_1269,1,1,1,0,1
,"",_1270,1,1,1,0,1
,"",_1271,1,1,1,0,1
,"",_1272,1,1,1,0,1
,"",_1273,1,1,0,0,0
,"",_1274,1,1,1,0,1
,"",_1275,1,1,1,0,1
,"",_1276,1,1,1,0,1
,"",_1277,1,1,1,0,1
,"",_1278,1,1,1,0,1
,"",_1279,1,1,1,0,1
,"",_1280,1,1,0,0,0
,"",_1281,1,1,1,0,1
,"",_1282,1,1,1,0,1
,"",_1283,1,1,1,0,1
,"",_1284,1,1,1,0,1
,"",_1285,1,1,1,0,1
,"",_1286,1,1,1,0,1
,"",_1287,1,1,1,0,1
,"",_1288,1,1,1,0,1
,"",_1289,1,1,1,0,1
,"",_1290,1,1,1,0,1
,"",_1291,1,1,1,0,1
,"",_1292,1,1,1,0,1
,"",_1293,1,1,1,0,1
,"",_1294,1,1,1,0,1
,"",_1295,1,1,1,0,1
,"",_1296,1,1,1,0,1
,"",_1297,1,1,1,0,1
,"",_1298,1,1,1,0,1
,"",_1299,1,1,1,0,1
,"",_1300,1,1,1,0,1
,"",_1301,1,1,0,0,0
,"",_1302,1,1,1,0,1
,"",_1303,1,1,1,0,1
,"",_1304,1,1,1,0,1
,"",_1305,1,1,1,0,1
,"",_1306,1,1,0,1,1
,"",_1307,1,1,1,0,1
,"",_1308,1,1,1,0,1
,"",_1309,1,1,1,0,1
,"",_1310,1,1,1,0,1
,"",_1311,1,1,1,0,1
,"",_1312,1,1,1,0,1
,"",_1313,1,1,1,0,1
,"",_1314,1,1,1,0,1
,"",_1315,1,1,1,0,1
,"",_1316,1,1,1,0,1
,"",_1317,1,1,1,0,1
,"",_1318,1,1,1,0,1
,"",_1319,1,1,1,0,1
,"",_1320,1,1,1,0,1
,"",_1321,1,1,1,0,1
,"",_1322,1,1,1,0,1
,"",_1323,1,1,1,0,1
,"",_1324,1,1,1,0,1
,"",_1325,1,1,1,0,1
,"",_1326,1,1,1,0,1
,"",_1327,1,1,1,0,1
,"",_1328,1,1,1,0,1
,"",_1329,1,1,1,0,1
,"",_1330,1,1,1,0,1
,"",_1331,1,1,0,0,0
,"",_1332,1,1,1,0,1
,"",_1333,1,1,1,0,1
,"",_1334,1,1,1,0,1
,"",_1335,1,1,1,0,1
,"",_1336,1,1,1,0,1
,"",_1337,1,1,1,0,1
,"",_1338,1,1,1,0,1
,"",_1339,1,1,1,0,1
,"",_1340,1,1,1,0,1
,"",_1341,1,1,1,0,1
,"",_1342,1,1,1,0,1
,"",_1343,1,1,1,0,1
,"",_1344,1,1,1,0,1
,"",_1345,1,1,1,0,1
,"",_1346,1,1,1,0,1
,"",_1347,1,1,1,0,1
,"",_1348,1,1,1,0,1
,"",_1349,1,1,1,0,1
,"",_1350,1,1,1,0,1
,"",_1351,1,1,1,0,1
,"",_1352,1,1,1,0,1
,"",_1353,1,1,1,0,1
,"",_1354,1,1,1,0,1
,"",_1355,1,1,1,0,1
,"",_1356,1,1,1,0,1
,"",_1357,1,1,1,0,1
,"",_1358,1,1,1,0,1
,"",_1359,1,1,0,0,0
,"",_1360,1,1,1,0,1
,"",_1361,1,1,1,0,1
,"",_1362,1,1,1,0,1
,"",_1363,1,1,1,0,1
,"",_1364,1,1,1,0,1
,"",_1365,1,1,1,0,1
,"",_1366,1,1,1,0,1
,"",_1367,1,1,0,1,1
,"",_1368,1,1,1,0,1
,"",_1369,1,1,1,0,1
,"",_1370,1,1,1,0,1
,"",_1371,1,1,1,0,1
,"",_1372,1,1,1,0,1
,"",_1373,1,1,1,0,1
,"",_1374,1,1,1,0,1
,"",_1375,1,1,1,0,1
,"",_1376,1,1,1,0,1
,"",_1377,1,1,1,0,1
,"",_1378,1,1,1,0,1
,"",_1379,1,1,1,0,1
,"",_1380,1,1,1,0,1
,"",_1381,1,1,1,0,1
,"",_1382,1,1,1,0,1

