Name,Description,Combined Group,Unique Machines,Unique UserID, Count F,Count H,EULA Machines
NTU,"",_12,153,109,148,2,150
,"",_1,98,95,85,10,95
,"",_2,72,70,29,38,67
Singapore Poly,"",_14,57,26,55,1,56
NYP,"",_22,51,46,47,0,47
,"",_3,49,41,36,3,39
,"",_4,40,33,25,1,26
Mages,"",_24,35,28,32,0,32
,"",_8,34,29,23,4,27
,"",_7,32,28,16,2,18
Unity,"",_5,28,26,13,1,14
,"",_15,26,25,16,1,17
,"",_9,25,25,13,0,13
,"",_6,23,19,13,2,15
NUS,"",_51,22,15,11,0,11
Singapore Poly / Chesterfield,"http://chesterfield.sg/
Singapore Polytechnic
",_30,21,17,20,0,20
,"",_11,19,18,13,1,14
Gumi,"",_27,18,17,2,0,2
Temasek Poly,"",_38,17,16,12,0,12
89trillion.com,"",_26,16,16,15,0,15
Koei Tecmo,"",_31,15,15,4,0,4
,"",_19,14,14,13,0,13
Tendays Studio / Ignite VR,"",_35,12,10,9,0,9
,"",_13,12,12,6,1,7
,"",_16,12,12,5,0,5
SIT,"",_79,11,9,11,0,11
IGG,"",_46,11,12,2,0,2
,"",_10,11,10,5,1,6
,"",_40,10,10,10,0,10
,"",_42,10,9,8,2,10
Yoozoo games,"https://global.yoozoo.com/news/7000056.html
",_44,9,10,9,0,9
GovTech,"rayjue99@hotmail.com
hazel77744@gmail.com
",_65,9,9,7,0,7
Aviation Virtual,"",_29,9,7,6,0,6
,"",_20,9,9,6,0,6
,"",_39,9,7,6,2,8
,"",_41,9,8,8,0,8
,"",_47,8,8,5,0,5
White Label Studio,"https://whitelabelstudio.global/
",_94,7,4,7,0,7
VR Collab,"",_72,7,3,2,0,2
Hiverlab,"https://www.hiverlab.com/
",_36,7,4,3,0,3
Exousia Studios,"",_110,7,6,7,0,7
Electricsquare,"",_66,7,7,2,0,2
,"",_23,7,7,4,1,5
Swagsoft,"",_52,6,5,2,0,2
Mighty Bear,"",_113,6,6,1,0,1
Chariots Gaming,"",_63,6,6,1,0,1
Autumn Interactive,"",_67,6,5,4,0,4
,"",_18,6,6,3,1,4
,"",_68,6,6,6,0,6
Vincent Goh,"",_70,5,5,5,0,5
Marina Bay Sands,"sinonet3d@gmail.com
https://genesis.hq.unity3d.com/organizations/18966836212561/
millernguyen.mbs@gmail.com
liulink@gmail.com
",_149,5,3,5,0,5
EON Reality,"",_74,5,4,0,0,0
,"",_17,5,6,4,1,5
,"",_45,5,5,4,0,4
,"",_56,5,5,4,0,4
,"",_62,5,5,5,0,5
The Carrot Studio,"",_86,4,4,3,0,3
SideFX Studios,"https://genesis.hq.unity3d.com/organizations/1374436136701/
",_78,4,5,1,0,1
Revez Digital,"http://revezdigital.com/
Plus license
",_80,4,3,4,0,4
Quantum Jump Tech,"http://qjdev.lihailouti.cn/%E5%85%B3%E4%BA%8E%E7%90%A6%E6%99%AF%E7%A7%91%E6%8A%80
https://genesis.hq.unity3d.com/organizations/18966610847599/members-groups
",_105,4,4,3,0,3
Land Shark Games,"",_165,4,4,0,0,0
ITE,"",_104,4,4,4,0,4
https://www.xiibraves.com/,"Org with 11 members
",_81,4,4,2,0,2
DSO HEDP,"",_84,4,4,3,0,3
Aviationlearn.com,"",_97,4,2,3,0,3
Anacle,"",_87,4,4,0,0,0
,"",_69,4,4,4,0,4
,"",_83,4,4,3,0,3
,"",_93,4,3,3,1,4
,"",_101,4,4,4,0,4
,"",_114,4,3,4,0,4
,"",_131,4,3,4,0,4
,"",_177,4,3,3,0,3
SUTD,"",_122,3,4,3,0,3
STE Training & Simulation,"leong.guowei@stengg.com	
liew.wanhui@stee.stengg.com
kohwuisiong2@gmail.com
",_99,3,3,2,0,2
Starstruck Games,"",_173,3,3,2,0,2
Silversea Media,"https://www.silversea-media.com/
",_153,3,3,1,2,3
Royce Media,"",_186,3,2,3,0,3
Presence Pictures VR,"https://app.presencepictures.com.sg/storePages/presenceImages/PresencePicturesAboutUs.pdf#toolbar=0&navpanes=0&scrollbar=0
",_103,3,2,2,0,2
NUS Engineering Design and Innovation Centre,"",_158,3,3,2,0,2
New Future Games,"",_241,3,3,3,0,3
Meshtint,"",_407,3,2,3,0,3
Korea user,"",_57,3,2,1,0,1
Hennery Studio,"",_168,3,2,3,0,3
Cybervision,"",_124,3,3,3,0,3
,"",_21,3,2,3,0,3
,"",_58,3,2,3,0,3
,"",_77,3,3,3,0,3
,"",_96,3,3,3,0,3
,"",_98,3,3,3,0,3
,"",_115,3,3,3,0,3
,"",_120,3,3,3,0,3
,"",_121,3,3,2,0,2
,"",_128,3,2,1,0,1
,"",_129,3,3,2,0,2
,"",_130,3,3,2,0,2
,"",_135,3,3,3,0,3
,"",_156,3,2,3,0,3
,"",_162,3,3,3,0,3
,"",_164,3,3,3,0,3
,"",_184,3,2,3,0,3
,"ST Engineering
",_185,3,3,3,0,3
,"",_272,3,2,3,0,3
,"",_418,3,2,3,0,3
Vividthree,"",_342,2,2,0,0,0
Terresqual,"",_151,2,1,2,0,2
StarSprite,"http://starsprite.com/
",_136,2,2,1,0,1
Singapore American School,"",_381,2,1,2,0,2
Siemens - Lim Riqui,"https://genesis.hq.unity3d.com/users/18966804306463/
",_266,2,1,2,0,2
Orca Studios,"",_251,2,2,0,0,0
Make Studios,"",_338,2,2,2,0,2
Bui_Thanh (VN),"",_297,2,2,0,2,2
Bandai Namco,"",_220,2,2,0,0,0
Azurite,"",_142,2,2,1,0,1
A-Star,"https://genesis.hq.unity3d.com/organizations/18966615602330/
",_453,2,3,1,0,1
Appigniter,"https://www.appigniter.co/
Plus license
",_176,2,1,0,0,0
Accenture / Beca,"",_292,2,2,0,0,0
AAT Training Hub,"",_126,2,1,0,0,0
,"",_54,2,2,2,0,2
,"",_64,2,2,2,0,2
,"",_75,2,2,2,0,2
,"",_82,2,1,2,0,2
,"",_89,2,2,1,0,1
,"",_100,2,1,1,0,1
,"",_106,2,1,2,0,2
,"",_108,2,1,2,0,2
,"",_109,2,2,2,0,2
,"",_112,2,2,2,0,2
,"",_123,2,2,2,0,2
,"",_127,2,1,2,0,2
,"",_132,2,1,1,0,1
,"",_139,2,1,2,0,2
,"",_141,2,2,2,0,2
,"",_148,2,2,2,0,2
,"",_154,2,2,2,0,2
,"",_159,2,2,2,0,2
,"",_160,2,2,1,0,1
,"",_169,2,2,2,0,2
,"",_174,2,2,2,0,2
,"",_175,2,2,2,0,2
,"",_180,2,2,1,0,1
,"",_187,2,2,2,0,2
,"",_190,2,1,2,0,2
,"",_194,2,2,1,1,2
,"",_196,2,2,2,0,2
,"",_198,2,1,2,0,2
,"",_204,2,2,2,0,2
,"",_205,2,1,2,0,2
,"",_206,2,2,1,0,1
,"",_207,2,2,2,0,2
,"",_208,2,2,2,0,2
,"",_212,2,2,2,0,2
,"",_217,2,2,2,0,2
,"",_218,2,2,0,1,1
,"",_219,2,2,2,0,2
,"",_222,2,2,2,0,2
,"",_233,2,2,1,1,2
,"",_234,2,2,1,0,1
,"",_237,2,1,2,0,2
,"",_245,2,1,2,0,2
,"",_247,2,2,2,0,2
,"",_254,2,1,2,0,2
,"",_260,2,1,2,0,2
,"",_270,2,2,2,0,2
,"",_271,2,2,2,0,2
,"",_273,2,2,2,0,2
,"",_282,2,2,2,0,2
,"",_288,2,2,2,0,2
,"",_289,2,1,2,0,2
,"",_291,2,2,2,0,2
,"",_303,2,2,2,0,2
,"",_310,2,1,2,0,2
,"",_311,2,1,2,0,2
,"",_312,2,1,2,0,2
,"",_318,2,1,2,0,2
,"",_321,2,2,2,0,2
,"",_322,2,1,1,1,2
,"",_323,2,2,1,0,1
,"",_325,2,2,2,0,2
,"",_326,2,1,0,0,0
,"",_327,2,2,2,0,2
,"",_330,2,2,2,0,2
,"",_333,2,2,2,0,2
,"",_337,2,1,2,0,2
,"",_340,2,1,2,0,2
,"",_341,2,2,2,0,2
,"",_354,2,2,2,0,2
,"",_355,2,1,2,0,2
,"",_360,2,2,2,0,2
,"",_365,2,1,2,0,2
,"",_369,2,2,2,0,2
,"",_372,2,2,2,0,2
,"",_389,2,1,2,0,2
,"",_402,2,2,2,0,2
,"",_411,2,2,2,0,2
,"",_412,2,2,2,0,2
,"",_415,2,1,2,0,2
,"",_417,2,2,2,0,2
,"",_440,2,1,2,0,2
,"ST Engineering
",_452,2,1,2,0,2
,"",_504,2,1,2,0,2
,"",_565,2,1,2,0,2
,"",_612,2,1,2,0,2
,"",_661,2,1,2,0,2
,"",_670,2,1,0,0,0
,"",_719,2,1,2,0,2
,"",_738,2,1,1,0,1
,"",_753,2,1,2,0,2
,"",_805,2,1,2,0,2
,"",_877,2,1,1,0,1
,"",_1058,2,1,0,0,0
Visenze,"",_855,1,1,1,0,1
Ubisoft,"https://genesis.hq.unity3d.com/users/20066241185396/
",_616,1,1,0,0,0
Trinax,"",_163,1,1,0,0,0
The iterative Collective,"https://theiterative.co/
",_439,1,1,1,0,1
Taggle Health,"",_1148,1,1,0,0,0
ST Engineering Land Systems,"",_229,1,1,0,0,0
Singnet,"",_1286,1,1,1,0,1
Shadowbyte Games,"",_343,1,1,0,0,0
Sandbox VR,"",_1265,1,1,0,0,0
PlayTech Studio,"",_1180,1,1,1,0,1
Pern Jie,"",_815,1,1,1,0,1
NUS-HCI Lab,"",_926,1,1,1,0,1
NTU VR Lab,"",_305,1,1,1,0,1
Nanyang Poly,"",_140,1,1,0,0,0
MyCard,"",_727,1,1,1,0,1
Mersiva LLP / Iceberg Design,"",_623,1,1,1,0,1
Kingmaker Games,"https://kingmakergames.co/
",_618,1,1,1,0,1
Indonesia user,"",_854,1,1,1,0,1
DSTA,"https://genesis.hq.unity3d.com/users/5336777/
",_1047,1,1,1,0,1
Brandon Gui,"",_117,1,1,0,0,0
,"",_71,1,1,0,0,0
,"",_76,1,1,1,0,1
,"",_85,1,1,1,0,1
,"",_88,1,1,1,0,1
,"",_90,1,1,1,0,1
,"",_92,1,1,1,0,1
,"",_95,1,1,1,0,1
,"",_102,1,1,1,0,1
,"",_107,1,1,1,0,1
,"",_118,1,1,1,0,1
,"",_119,1,2,1,0,1
,"",_125,1,1,1,0,1
,"",_133,1,1,0,0,0
,"",_134,1,2,1,0,1
,"",_137,1,1,1,0,1
,"",_138,1,1,1,0,1
,"",_143,1,1,1,0,1
,"",_145,1,1,1,0,1
,"",_146,1,1,1,0,1
,"",_150,1,1,1,0,1
,"",_152,1,1,0,0,0
,"",_155,1,1,1,0,1
,"",_161,1,1,1,0,1
,"",_170,1,1,1,0,1
,"",_171,1,1,0,1,1
,"",_172,1,1,1,0,1
,"",_178,1,1,1,0,1
,"",_181,1,1,1,0,1
,"",_182,1,1,1,0,1
,"",_183,1,1,1,0,1
,"",_188,1,1,1,0,1
,"",_191,1,1,1,0,1
,"",_192,1,1,0,0,0
,"",_193,1,1,1,0,1
,"",_195,1,1,0,1,1
,"",_197,1,1,1,0,1
,"",_200,1,2,1,0,1
,"",_201,1,1,1,0,1
,"",_202,1,1,1,0,1
,"",_209,1,1,1,0,1
,"",_210,1,1,1,0,1
,"",_211,1,1,1,0,1
,"",_213,1,1,1,0,1
,"",_214,1,1,1,0,1
,"",_215,1,1,0,1,1
,"",_216,1,1,1,0,1
,"",_221,1,1,1,0,1
,"",_223,1,1,1,0,1
,"",_224,1,1,1,0,1
,"",_225,1,1,1,0,1
,"",_226,1,1,1,0,1
,"",_227,1,1,1,0,1
,"",_228,1,1,0,0,0
,"",_231,1,1,1,0,1
,"",_232,1,1,1,0,1
,"",_235,1,1,1,0,1
,"",_236,1,1,1,0,1
,"",_239,1,1,1,0,1
,"",_240,1,1,1,0,1
,"",_242,1,1,1,0,1
,"",_243,1,1,1,0,1
,"",_244,1,1,1,0,1
,"",_246,1,1,1,0,1
,"",_248,1,1,1,0,1
,"",_249,1,1,1,0,1
,"",_250,1,1,1,0,1
,"",_252,1,1,1,0,1
,"",_255,1,1,0,1,1
,"",_256,1,1,1,0,1
,"",_257,1,1,1,0,1
,"",_258,1,1,1,0,1
,"",_259,1,1,1,0,1
,"",_261,1,1,1,0,1
,"",_262,1,1,1,0,1
,"",_263,1,1,1,0,1
,"",_264,1,1,1,0,1
,"",_265,1,1,1,0,1
,"",_267,1,1,1,0,1
,"",_268,1,1,1,0,1
,"",_269,1,1,1,0,1
,"",_274,1,1,1,0,1
,"",_275,1,1,1,0,1
,"",_276,1,1,0,0,0
,"",_277,1,1,1,0,1
,"",_278,1,1,1,0,1
,"",_279,1,1,1,0,1
,"",_280,1,1,1,0,1
,"",_281,1,1,1,0,1
,"",_283,1,1,1,0,1
,"",_284,1,1,0,0,0
,"",_285,1,1,1,0,1
,"",_286,1,1,1,0,1
,"",_287,1,1,1,0,1
,"",_290,1,1,0,1,1
,"",_294,1,1,1,0,1
,"",_295,1,1,1,0,1
,"",_296,1,1,1,0,1
,"",_298,1,1,1,0,1
,"",_299,1,1,1,0,1
,"",_300,1,1,1,0,1
,"",_302,1,1,1,0,1
,"",_304,1,1,0,0,0
,"",_306,1,1,1,0,1
,"",_307,1,1,0,0,0
,"",_308,1,1,0,0,0
,"",_313,1,1,0,0,0
,"",_314,1,1,1,0,1
,"",_315,1,1,0,0,0
,"",_316,1,1,1,0,1
,"",_317,1,1,1,0,1
,"",_319,1,1,1,0,1
,"",_320,1,1,1,0,1
,"",_324,1,1,0,0,0
,"",_328,1,1,1,0,1
,"",_329,1,1,1,0,1
,"",_331,1,1,1,0,1
,"",_332,1,2,1,0,1
,"",_334,1,1,1,0,1
,"",_335,1,1,1,0,1
,"",_336,1,1,1,0,1
,"",_339,1,1,1,0,1
,"",_344,1,1,0,0,0
,"",_345,1,1,1,0,1
,"",_346,1,1,1,0,1
,"",_347,1,1,1,0,1
,"",_348,1,1,1,0,1
,"",_349,1,1,1,0,1
,"",_350,1,1,1,0,1
,"",_351,1,1,1,0,1
,"",_357,1,1,0,0,0
,"",_358,1,1,0,0,0
,"",_359,1,1,1,0,1
,"",_361,1,1,1,0,1
,"",_362,1,1,0,0,0
,"",_363,1,1,1,0,1
,"",_364,1,1,1,0,1
,"",_366,1,1,0,0,0
,"",_368,1,1,1,0,1
,"",_370,1,1,1,0,1
,"",_371,1,1,1,0,1
,"",_373,1,1,1,0,1
,"",_374,1,1,0,0,0
,"",_375,1,1,1,0,1
,"",_376,1,1,1,0,1
,"",_377,1,1,1,0,1
,"",_378,1,1,1,0,1
,"",_379,1,1,1,0,1
,"",_380,1,1,1,0,1
,"",_382,1,1,1,0,1
,"",_383,1,1,1,0,1
,"",_384,1,1,1,0,1
,"",_385,1,1,0,0,0
,"",_386,1,1,1,0,1
,"",_387,1,1,1,0,1
,"",_388,1,1,1,0,1
,"",_390,1,1,1,0,1
,"",_391,1,1,1,0,1
,"",_393,1,1,1,0,1
,"",_394,1,1,1,0,1
,"",_395,1,1,1,0,1
,"",_396,1,2,1,0,1
,"",_397,1,1,1,0,1
,"",_398,1,1,0,1,1
,"",_399,1,1,1,0,1
,"",_400,1,1,1,0,1
,"",_401,1,1,1,0,1
,"",_403,1,1,1,0,1
,"",_404,1,1,1,0,1
,"",_409,1,1,1,0,1
,"",_410,1,1,1,0,1
,"",_413,1,1,1,0,1
,"",_414,1,1,1,0,1
,"",_416,1,1,1,0,1
,"",_419,1,1,1,0,1
,"",_420,1,1,1,0,1
,"",_421,1,1,1,0,1
,"",_422,1,1,1,0,1
,"",_423,1,1,1,0,1
,"",_424,1,1,1,0,1
,"",_425,1,1,1,0,1
,"",_426,1,1,1,0,1
,"",_427,1,1,1,0,1
,"",_428,1,1,0,0,0
,"",_429,1,1,1,0,1
,"",_430,1,1,1,0,1
,"",_431,1,1,1,0,1
,"",_432,1,1,0,0,0
,"",_433,1,1,1,0,1
,"",_434,1,1,1,0,1
,"",_435,1,1,1,0,1
,"",_436,1,1,1,0,1
,"",_437,1,1,0,0,0
,"",_438,1,1,1,0,1
,"",_441,1,1,1,0,1
,"",_442,1,1,1,0,1
,"",_443,1,1,1,0,1
,"",_444,1,1,1,0,1
,"",_445,1,1,1,0,1
,"",_446,1,1,1,0,1
,"",_447,1,1,0,0,0
,"",_448,1,1,0,0,0
,"",_449,1,1,1,0,1
,"",_450,1,1,1,0,1
,"",_451,1,1,1,0,1
,"",_454,1,1,1,0,1
,"",_455,1,1,1,0,1
,"",_456,1,1,1,0,1
,"",_457,1,1,1,0,1
,"",_458,1,1,0,1,1
,"",_459,1,1,1,0,1
,"",_461,1,1,1,0,1
,"",_462,1,1,1,0,1
,"",_463,1,1,1,0,1
,"",_464,1,1,1,0,1
,"",_465,1,1,1,0,1
,"",_466,1,1,1,0,1
,"",_467,1,1,1,0,1
,"",_468,1,1,1,0,1
,"",_469,1,1,1,0,1
,"",_470,1,1,1,0,1
,"",_471,1,1,1,0,1
,"",_472,1,1,1,0,1
,"",_473,1,1,1,0,1
,"",_474,1,1,1,0,1
,"",_475,1,1,1,0,1
,"",_476,1,1,1,0,1
,"",_477,1,1,1,0,1
,"",_479,1,1,1,0,1
,"",_480,1,1,1,0,1
,"",_481,1,1,1,0,1
,"",_482,1,1,1,0,1
,"",_483,1,1,1,0,1
,"",_484,1,1,1,0,1
,"",_485,1,1,1,0,1
,"",_486,1,1,0,1,1
,"",_487,1,1,1,0,1
,"",_488,1,1,1,0,1
,"",_489,1,1,1,0,1
,"",_490,1,1,1,0,1
,"",_491,1,1,1,0,1
,"",_492,1,1,1,0,1
,"",_493,1,1,1,0,1
,"",_494,1,1,1,0,1
,"",_495,1,1,1,0,1
,"",_496,1,1,1,0,1
,"",_497,1,1,1,0,1
,"",_498,1,1,1,0,1
,"",_499,1,1,0,1,1
,"",_500,1,1,1,0,1
,"",_501,1,1,1,0,1
,"",_503,1,1,1,0,1
,"",_505,1,1,1,0,1
,"",_506,1,1,1,0,1
,"",_507,1,1,1,0,1
,"",_508,1,1,1,0,1
,"",_509,1,1,1,0,1
,"",_510,1,1,1,0,1
,"",_511,1,1,1,0,1
,"",_512,1,1,1,0,1
,"",_513,1,1,1,0,1
,"",_514,1,1,1,0,1
,"",_515,1,1,0,0,0
,"",_516,1,1,1,0,1
,"",_517,1,1,1,0,1
,"",_518,1,1,1,0,1
,"",_519,1,1,0,0,0
,"",_520,1,1,1,0,1
,"",_521,1,1,1,0,1
,"",_522,1,1,1,0,1
,"",_523,1,1,1,0,1
,"",_524,1,1,1,0,1
,"",_525,1,1,0,1,1
,"",_526,1,1,0,1,1
,"",_527,1,1,0,1,1
,"",_528,1,1,1,0,1
,"",_529,1,1,1,0,1
,"",_530,1,1,1,0,1
,"",_531,1,1,1,0,1
,"",_532,1,1,1,0,1
,"",_533,1,1,1,0,1
,"",_534,1,1,1,0,1
,"",_535,1,1,1,0,1
,"",_536,1,1,1,0,1
,"",_537,1,1,0,1,1
,"",_538,1,1,1,0,1
,"",_539,1,1,1,0,1
,"",_540,1,1,1,0,1
,"",_541,1,1,1,0,1
,"",_542,1,1,1,0,1
,"",_543,1,1,1,0,1
,"",_544,1,1,1,0,1
,"",_545,1,1,1,0,1
,"",_546,1,1,1,0,1
,"",_547,1,1,1,0,1
,"",_549,1,1,1,0,1
,"",_550,1,1,1,0,1
,"",_551,1,1,1,0,1
,"",_552,1,1,1,0,1
,"",_553,1,1,1,0,1
,"",_554,1,1,1,0,1
,"",_555,1,1,1,0,1
,"",_556,1,1,1,0,1
,"",_557,1,1,1,0,1
,"",_558,1,1,0,0,0
,"",_559,1,1,1,0,1
,"",_560,1,1,0,0,0
,"",_561,1,1,1,0,1
,"",_562,1,1,1,0,1
,"",_563,1,1,1,0,1
,"",_564,1,1,1,0,1
,"",_566,1,1,1,0,1
,"",_568,1,1,1,0,1
,"",_569,1,1,1,0,1
,"",_570,1,1,1,0,1
,"",_571,1,1,1,0,1
,"",_572,1,1,1,0,1
,"",_573,1,1,1,0,1
,"",_574,1,1,1,0,1
,"",_575,1,1,1,0,1
,"",_576,1,1,1,0,1
,"",_577,1,1,1,0,1
,"",_578,1,1,1,0,1
,"",_580,1,1,1,0,1
,"",_582,1,1,1,0,1
,"",_583,1,1,1,0,1
,"",_584,1,1,1,0,1
,"",_585,1,1,1,0,1
,"",_586,1,1,1,0,1
,"",_587,1,1,1,0,1
,"",_588,1,1,1,0,1
,"",_589,1,1,1,0,1
,"",_590,1,1,1,0,1
,"",_591,1,1,1,0,1
,"",_592,1,1,1,0,1
,"",_593,1,1,1,0,1
,"",_594,1,1,1,0,1
,"",_595,1,1,1,0,1
,"",_596,1,1,0,0,0
,"",_597,1,1,1,0,1
,"",_598,1,1,1,0,1
,"",_599,1,1,1,0,1
,"",_601,1,1,1,0,1
,"",_602,1,1,1,0,1
,"",_603,1,1,0,0,0
,"",_605,1,1,0,0,0
,"",_606,1,1,1,0,1
,"",_607,1,1,1,0,1
,"",_608,1,1,1,0,1
,"",_609,1,1,1,0,1
,"",_610,1,1,1,0,1
,"",_611,1,1,1,0,1
,"",_613,1,1,1,0,1
,"",_614,1,1,1,0,1
,"",_615,1,1,1,0,1
,"",_617,1,1,0,0,0
,"",_619,1,1,1,0,1
,"",_620,1,1,1,0,1
,"",_621,1,1,1,0,1
,"",_622,1,1,1,0,1
,"",_624,1,1,1,0,1
,"",_625,1,1,1,0,1
,"",_626,1,1,1,0,1
,"",_627,1,1,1,0,1
,"",_628,1,1,1,0,1
,"",_629,1,1,1,0,1
,"",_630,1,1,1,0,1
,"",_631,1,1,1,0,1
,"",_632,1,1,1,0,1
,"",_633,1,1,1,0,1
,"",_634,1,1,0,0,0
,"",_635,1,1,1,0,1
,"",_636,1,1,1,0,1
,"",_637,1,1,1,0,1
,"",_638,1,1,1,0,1
,"",_639,1,1,1,0,1
,"",_640,1,1,1,0,1
,"",_641,1,1,0,1,1
,"",_642,1,1,1,0,1
,"",_643,1,1,1,0,1
,"",_644,1,1,1,0,1
,"",_645,1,1,1,0,1
,"",_646,1,1,1,0,1
,"",_647,1,1,1,0,1
,"",_648,1,1,1,0,1
,"",_650,1,1,1,0,1
,"",_651,1,1,1,0,1
,"",_652,1,1,0,0,0
,"",_653,1,1,0,0,0
,"",_654,1,1,1,0,1
,"",_655,1,1,1,0,1
,"",_656,1,1,1,0,1
,"",_657,1,1,1,0,1
,"",_658,1,1,1,0,1
,"",_659,1,1,1,0,1
,"",_660,1,1,1,0,1
,"",_662,1,1,1,0,1
,"",_663,1,1,1,0,1
,"",_664,1,1,0,1,1
,"",_665,1,1,1,0,1
,"",_666,1,1,1,0,1
,"",_667,1,1,1,0,1
,"",_668,1,1,1,0,1
,"",_671,1,1,1,0,1
,"",_672,1,1,1,0,1
,"",_673,1,1,1,0,1
,"",_674,1,1,1,0,1
,"",_675,1,1,1,0,1
,"",_676,1,1,1,0,1
,"",_677,1,1,1,0,1
,"",_678,1,1,1,0,1
,"",_679,1,1,1,0,1
,"",_680,1,1,1,0,1
,"",_681,1,1,1,0,1
,"",_683,1,1,1,0,1
,"",_684,1,1,1,0,1
,"",_686,1,1,1,0,1
,"",_687,1,1,1,0,1
,"",_688,1,1,1,0,1
,"",_689,1,1,1,0,1
,"",_690,1,1,1,0,1
,"",_692,1,1,1,0,1
,"",_693,1,1,1,0,1
,"",_694,1,1,1,0,1
,"",_695,1,1,1,0,1
,"",_696,1,1,1,0,1
,"",_697,1,1,1,0,1
,"",_698,1,1,1,0,1
,"",_700,1,1,1,0,1
,"",_701,1,1,1,0,1
,"",_702,1,1,1,0,1
,"",_703,1,1,1,0,1
,"",_704,1,1,1,0,1
,"",_705,1,1,1,0,1
,"",_707,1,1,1,0,1
,"",_708,1,1,1,0,1
,"",_709,1,1,1,0,1
,"",_710,1,1,1,0,1
,"",_711,1,1,1,0,1
,"",_712,1,1,1,0,1
,"",_713,1,1,1,0,1
,"",_714,1,1,1,0,1
,"",_715,1,1,1,0,1
,"",_716,1,1,1,0,1
,"",_717,1,1,0,1,1
,"",_718,1,1,1,0,1
,"",_720,1,1,1,0,1
,"",_721,1,1,1,0,1
,"",_722,1,1,0,0,0
,"",_723,1,1,1,0,1
,"",_724,1,1,1,0,1
,"",_725,1,1,1,0,1
,"",_726,1,1,1,0,1
,"",_728,1,1,1,0,1
,"",_729,1,1,0,0,0
,"",_730,1,1,0,0,0
,"",_731,1,1,1,0,1
,"",_732,1,1,1,0,1
,"",_733,1,1,1,0,1
,"",_734,1,1,1,0,1
,"",_735,1,1,1,0,1
,"",_736,1,1,1,0,1
,"",_737,1,1,1,0,1
,"",_739,1,1,1,0,1
,"",_740,1,1,1,0,1
,"",_741,1,1,1,0,1
,"",_742,1,1,1,0,1
,"",_743,1,1,1,0,1
,"",_744,1,1,1,0,1
,"",_745,1,1,1,0,1
,"",_746,1,1,1,0,1
,"",_747,1,1,1,0,1
,"",_748,1,1,1,0,1
,"",_749,1,1,1,0,1
,"",_750,1,1,1,0,1
,"",_751,1,1,1,0,1
,"",_752,1,1,1,0,1
,"",_754,1,1,1,0,1
,"",_755,1,1,1,0,1
,"",_756,1,1,1,0,1
,"",_757,1,1,1,0,1
,"",_758,1,1,1,0,1
,"",_759,1,1,0,0,0
,"",_760,1,1,1,0,1
,"",_761,1,1,1,0,1
,"",_763,1,1,1,0,1
,"",_764,1,1,1,0,1
,"",_765,1,1,1,0,1
,"",_766,1,1,1,0,1
,"",_767,1,1,1,0,1
,"",_768,1,1,0,0,0
,"",_769,1,1,0,0,0
,"",_770,1,1,1,0,1
,"",_771,1,1,0,0,0
,"",_772,1,1,0,0,0
,"",_773,1,1,1,0,1
,"",_774,1,1,1,0,1
,"",_775,1,1,1,0,1
,"",_776,1,1,1,0,1
,"",_777,1,1,1,0,1
,"",_778,1,1,1,0,1
,"",_779,1,1,1,0,1
,"",_780,1,1,1,0,1
,"",_781,1,1,1,0,1
,"",_782,1,1,1,0,1
,"",_783,1,1,1,0,1
,"",_784,1,1,1,0,1
,"",_785,1,1,1,0,1
,"",_786,1,1,1,0,1
,"",_787,1,1,1,0,1
,"",_788,1,1,1,0,1
,"",_789,1,1,1,0,1
,"",_790,1,1,1,0,1
,"",_792,1,1,1,0,1
,"",_793,1,1,1,0,1
,"",_794,1,1,1,0,1
,"",_795,1,1,1,0,1
,"",_796,1,1,1,0,1
,"",_797,1,1,1,0,1
,"",_798,1,1,1,0,1
,"",_799,1,1,1,0,1
,"",_800,1,1,1,0,1
,"",_801,1,1,1,0,1
,"",_802,1,1,1,0,1
,"",_803,1,1,1,0,1
,"",_804,1,1,1,0,1
,"",_806,1,1,1,0,1
,"",_807,1,1,1,0,1
,"",_808,1,1,0,0,0
,"",_809,1,1,1,0,1
,"",_810,1,1,1,0,1
,"",_811,1,1,1,0,1
,"",_812,1,1,1,0,1
,"",_813,1,1,1,0,1
,"",_814,1,1,1,0,1
,"",_816,1,1,1,0,1
,"",_817,1,1,1,0,1
,"",_818,1,1,1,0,1
,"",_819,1,1,1,0,1
,"",_820,1,1,1,0,1
,"",_821,1,1,1,0,1
,"",_822,1,1,1,0,1
,"",_823,1,1,1,0,1
,"",_824,1,1,1,0,1
,"",_825,1,1,1,0,1
,"",_826,1,1,1,0,1
,"",_827,1,1,1,0,1
,"",_828,1,1,1,0,1
,"",_829,1,1,1,0,1
,"",_830,1,1,1,0,1
,"",_831,1,1,1,0,1
,"",_832,1,1,1,0,1
,"",_833,1,1,0,1,1
,"",_834,1,1,1,0,1
,"",_835,1,1,1,0,1
,"",_836,1,1,1,0,1
,"",_837,1,1,1,0,1
,"",_838,1,1,0,0,0
,"",_839,1,1,1,0,1
,"",_840,1,1,1,0,1
,"",_841,1,1,1,0,1
,"",_842,1,1,0,1,1
,"",_843,1,1,1,0,1
,"",_844,1,1,1,0,1
,"",_845,1,1,0,0,0
,"",_846,1,1,1,0,1
,"",_847,1,1,1,0,1
,"",_848,1,1,1,0,1
,"",_849,1,1,1,0,1
,"",_850,1,1,0,1,1
,"",_851,1,1,1,0,1
,"",_852,1,1,1,0,1
,"",_853,1,1,1,0,1
,"",_856,1,1,1,0,1
,"",_857,1,1,1,0,1
,"",_858,1,1,1,0,1
,"",_859,1,1,1,0,1
,"",_860,1,1,1,0,1
,"",_861,1,1,1,0,1
,"",_862,1,1,1,0,1
,"",_863,1,1,1,0,1
,"",_864,1,1,1,0,1
,"",_866,1,1,1,0,1
,"",_868,1,1,1,0,1
,"",_869,1,1,1,0,1
,"",_870,1,1,1,0,1
,"",_871,1,1,1,0,1
,"",_872,1,1,1,0,1
,"",_873,1,1,1,0,1
,"",_874,1,1,1,0,1
,"",_875,1,1,0,0,0
,"",_878,1,1,1,0,1
,"",_880,1,1,1,0,1
,"",_881,1,1,1,0,1
,"",_882,1,1,1,0,1
,"",_883,1,1,1,0,1
,"",_884,1,1,1,0,1
,"",_885,1,1,1,0,1
,"",_886,1,1,1,0,1
,"",_888,1,1,1,0,1
,"",_889,1,1,1,0,1
,"",_890,1,1,0,0,0
,"",_891,1,1,1,0,1
,"",_892,1,1,1,0,1
,"",_893,1,1,1,0,1
,"",_894,1,1,1,0,1
,"",_895,1,1,1,0,1
,"",_896,1,1,1,0,1
,"",_897,1,1,1,0,1
,"",_898,1,1,1,0,1
,"",_899,1,1,1,0,1
,"",_900,1,1,1,0,1
,"",_901,1,1,1,0,1
,"",_902,1,1,1,0,1
,"",_903,1,1,1,0,1
,"",_904,1,1,1,0,1
,"",_905,1,1,1,0,1
,"",_906,1,1,1,0,1
,"",_907,1,1,1,0,1
,"",_908,1,1,1,0,1
,"",_909,1,1,1,0,1
,"",_910,1,1,0,0,0
,"",_911,1,1,1,0,1
,"",_912,1,1,1,0,1
,"",_913,1,1,1,0,1
,"",_914,1,1,1,0,1
,"",_915,1,1,1,0,1
,"",_916,1,1,1,0,1
,"",_917,1,1,1,0,1
,"",_918,1,1,1,0,1
,"",_919,1,1,1,0,1
,"",_920,1,1,1,0,1
,"",_921,1,1,1,0,1
,"",_922,1,1,1,0,1
,"",_923,1,1,0,0,0
,"",_924,1,1,1,0,1
,"",_925,1,1,1,0,1
,"",_927,1,1,1,0,1
,"",_928,1,1,1,0,1
,"",_929,1,1,1,0,1
,"",_930,1,1,0,0,0
,"",_931,1,1,1,0,1
,"",_932,1,1,1,0,1
,"",_933,1,1,1,0,1
,"",_935,1,1,1,0,1
,"",_936,1,1,0,1,1
,"",_937,1,1,0,0,0
,"",_938,1,1,1,0,1
,"",_939,1,1,1,0,1
,"",_940,1,1,1,0,1
,"",_941,1,1,1,0,1
,"",_942,1,1,1,0,1
,"",_943,1,1,1,0,1
,"",_944,1,1,0,0,0
,"",_945,1,1,1,0,1
,"",_946,1,1,1,0,1
,"",_947,1,1,1,0,1
,"",_948,1,1,1,0,1
,"",_949,1,1,1,0,1
,"",_950,1,1,1,0,1
,"",_951,1,1,1,0,1
,"",_952,1,1,1,0,1
,"",_953,1,1,1,0,1
,"",_954,1,1,0,1,1
,"",_955,1,1,0,1,1
,"",_956,1,1,1,0,1
,"",_957,1,1,1,0,1
,"",_958,1,1,1,0,1
,"",_959,1,1,1,0,1
,"",_960,1,1,1,0,1
,"",_961,1,1,1,0,1
,"",_962,1,1,1,0,1
,"",_963,1,1,1,0,1
,"",_964,1,1,1,0,1
,"",_965,1,1,1,0,1
,"",_966,1,1,1,0,1
,"",_967,1,1,1,0,1
,"",_968,1,1,0,1,1
,"",_969,1,1,1,0,1
,"",_970,1,1,1,0,1
,"",_971,1,1,1,0,1
,"",_972,1,1,1,0,1
,"",_973,1,1,1,0,1
,"",_974,1,1,1,0,1
,"",_975,1,1,1,0,1
,"",_976,1,1,1,0,1
,"",_977,1,1,1,0,1
,"",_978,1,1,1,0,1
,"",_979,1,1,0,0,0
,"",_980,1,1,1,0,1
,"",_981,1,1,1,0,1
,"",_982,1,1,1,0,1
,"",_983,1,1,1,0,1
,"",_984,1,1,1,0,1
,"",_985,1,1,1,0,1
,"",_986,1,1,1,0,1
,"",_988,1,1,1,0,1
,"",_989,1,1,1,0,1
,"",_990,1,1,1,0,1
,"",_991,1,1,1,0,1
,"",_992,1,1,1,0,1
,"",_993,1,1,1,0,1
,"",_994,1,1,1,0,1
,"",_995,1,1,1,0,1
,"",_996,1,1,1,0,1
,"",_997,1,1,1,0,1
,"",_998,1,1,1,0,1
,"",_999,1,1,1,0,1
,"",_1000,1,1,1,0,1
,"",_1001,1,1,1,0,1
,"",_1002,1,1,1,0,1
,"",_1003,1,1,0,0,0
,"",_1004,1,1,1,0,1
,"",_1005,1,1,1,0,1
,"",_1006,1,1,1,0,1
,"",_1007,1,1,1,0,1
,"",_1008,1,1,1,0,1
,"",_1009,1,1,1,0,1
,"",_1010,1,1,1,0,1
,"",_1011,1,1,1,0,1
,"",_1012,1,1,1,0,1
,"",_1013,1,1,1,0,1
,"",_1014,1,1,0,0,0
,"",_1015,1,1,1,0,1
,"",_1016,1,1,1,0,1
,"",_1017,1,1,1,0,1
,"",_1018,1,1,1,0,1
,"",_1019,1,1,1,0,1
,"",_1021,1,1,1,0,1
,"",_1022,1,1,1,0,1
,"",_1023,1,1,1,0,1
,"",_1024,1,1,1,0,1
,"",_1025,1,1,1,0,1
,"",_1026,1,1,1,0,1
,"",_1027,1,1,1,0,1
,"",_1028,1,1,1,0,1
,"",_1029,1,1,1,0,1
,"",_1030,1,1,1,0,1
,"",_1031,1,1,0,1,1
,"",_1032,1,1,1,0,1
,"",_1033,1,1,1,0,1
,"",_1034,1,1,1,0,1
,"",_1035,1,1,1,0,1
,"",_1036,1,1,1,0,1
,"",_1037,1,1,1,0,1
,"",_1038,1,1,1,0,1
,"",_1039,1,1,1,0,1
,"",_1040,1,1,1,0,1
,"",_1041,1,1,1,0,1
,"",_1042,1,1,1,0,1
,"",_1043,1,1,1,0,1
,"",_1044,1,1,1,0,1
,"",_1045,1,1,1,0,1
,"",_1046,1,1,1,0,1
,"",_1048,1,1,1,0,1
,"",_1049,1,1,1,0,1
,"",_1051,1,1,1,0,1
,"",_1052,1,1,1,0,1
,"",_1053,1,1,1,0,1
,"",_1055,1,1,1,0,1
,"",_1056,1,1,1,0,1
,"",_1057,1,1,1,0,1
,"ST Engineering
",_1059,1,1,1,0,1
,"",_1060,1,1,1,0,1
,"",_1061,1,1,1,0,1
,"",_1062,1,1,1,0,1
,"",_1063,1,1,1,0,1
,"",_1064,1,1,0,1,1
,"",_1065,1,1,1,0,1
,"",_1066,1,1,1,0,1
,"",_1067,1,1,1,0,1
,"",_1068,1,1,1,0,1
,"",_1069,1,1,1,0,1
,"",_1070,1,1,1,0,1
,"",_1071,1,1,1,0,1
,"",_1072,1,1,1,0,1
,"",_1073,1,1,1,0,1
,"",_1074,1,1,1,0,1
,"",_1075,1,1,1,0,1
,"",_1076,1,1,0,0,0
,"",_1077,1,1,1,0,1
,"",_1078,1,1,1,0,1
,"",_1079,1,1,1,0,1
,"",_1080,1,1,1,0,1
,"",_1081,1,1,1,0,1
,"",_1082,1,1,1,0,1
,"",_1083,1,1,1,0,1
,"",_1084,1,1,1,0,1
,"",_1086,1,1,0,1,1
,"",_1087,1,1,0,0,0
,"",_1088,1,1,1,0,1
,"",_1089,1,1,1,0,1
,"",_1090,1,1,1,0,1
,"",_1092,1,1,1,0,1
,"",_1093,1,1,1,0,1
,"",_1094,1,1,1,0,1
,"",_1095,1,1,1,0,1
,"",_1096,1,1,1,0,1
,"",_1098,1,1,1,0,1
,"",_1099,1,1,1,0,1
,"",_1100,1,1,1,0,1
,"",_1101,1,1,1,0,1
,"",_1102,1,1,1,0,1
,"",_1103,1,1,1,0,1
,"",_1104,1,1,1,0,1
,"",_1105,1,1,1,0,1
,"",_1106,1,1,1,0,1
,"",_1107,1,1,1,0,1
,"",_1108,1,1,1,0,1
,"",_1109,1,1,1,0,1
,"",_1110,1,1,1,0,1
,"",_1111,1,1,1,0,1
,"",_1112,1,1,1,0,1
,"",_1113,1,1,1,0,1
,"",_1114,1,1,1,0,1
,"",_1115,1,1,1,0,1
,"",_1116,1,1,1,0,1
,"",_1117,1,1,1,0,1
,"",_1118,1,1,1,0,1
,"",_1119,1,1,1,0,1
,"",_1120,1,1,1,0,1
,"",_1121,1,1,1,0,1
,"",_1122,1,1,1,0,1
,"",_1123,1,1,1,0,1
,"",_1124,1,1,1,0,1
,"",_1125,1,1,1,0,1
,"",_1127,1,1,1,0,1
,"",_1128,1,1,1,0,1
,"",_1129,1,1,1,0,1
,"",_1130,1,1,1,0,1
,"",_1131,1,1,1,0,1
,"",_1132,1,1,1,0,1
,"",_1133,1,1,1,0,1
,"",_1134,1,1,1,0,1
,"",_1136,1,1,1,0,1
,"",_1137,1,1,1,0,1
,"",_1139,1,1,1,0,1
,"",_1140,1,1,1,0,1
,"",_1141,1,1,1,0,1
,"",_1142,1,1,1,0,1
,"",_1143,1,1,1,0,1
,"",_1144,1,1,1,0,1
,"",_1145,1,1,1,0,1
,"",_1146,1,1,1,0,1
,"",_1147,1,1,1,0,1
,"",_1149,1,1,1,0,1
,"",_1150,1,1,1,0,1
,"",_1151,1,1,0,0,0
,"",_1152,1,1,1,0,1
,"",_1153,1,1,0,0,0
,"",_1154,1,1,1,0,1
,"",_1155,1,1,1,0,1
,"",_1156,1,1,1,0,1
,"",_1157,1,1,0,0,0
,"",_1158,1,1,0,0,0
,"",_1159,1,1,1,0,1
,"",_1160,1,1,1,0,1
,"",_1161,1,1,1,0,1
,"",_1162,1,1,1,0,1
,"",_1163,1,1,1,0,1
,"",_1164,1,1,1,0,1
,"",_1165,1,1,1,0,1
,"",_1166,1,1,1,0,1
,"",_1167,1,1,1,0,1
,"",_1168,1,1,1,0,1
,"",_1169,1,1,1,0,1
,"",_1170,1,1,1,0,1
,"",_1171,1,1,1,0,1
,"",_1172,1,1,0,0,0
,"",_1173,1,1,1,0,1
,"",_1174,1,1,1,0,1
,"",_1175,1,1,1,0,1
,"",_1176,1,1,0,0,0
,"",_1177,1,1,1,0,1
,"",_1178,1,1,1,0,1
,"",_1179,1,1,1,0,1
,"",_1181,1,1,1,0,1
,"",_1182,1,1,1,0,1
,"",_1183,1,1,1,0,1
,"",_1184,1,1,1,0,1
,"",_1185,1,1,1,0,1
,"",_1187,1,1,1,0,1
,"",_1188,1,1,1,0,1
,"",_1189,1,1,1,0,1
,"",_1190,1,1,1,0,1
,"",_1191,1,1,1,0,1
,"",_1192,1,1,1,0,1
,"",_1193,1,1,1,0,1
,"",_1194,1,1,1,0,1
,"",_1196,1,1,1,0,1
,"",_1197,1,1,1,0,1
,"",_1199,1,1,1,0,1
,"",_1200,1,1,1,0,1
,"",_1201,1,1,1,0,1
,"",_1202,1,1,1,0,1
,"",_1204,1,1,1,0,1
,"",_1205,1,1,1,0,1
,"",_1206,1,1,1,0,1
,"",_1207,1,1,1,0,1
,"",_1208,1,1,1,0,1
,"",_1209,1,1,1,0,1
,"",_1210,1,1,1,0,1
,"",_1211,1,1,1,0,1
,"",_1212,1,1,1,0,1
,"",_1213,1,1,1,0,1
,"",_1214,1,1,0,0,0
,"",_1215,1,1,1,0,1
,"",_1216,1,1,1,0,1
,"",_1217,1,1,1,0,1
,"",_1218,1,1,1,0,1
,"",_1219,1,1,1,0,1
,"",_1220,1,1,1,0,1
,"",_1221,1,1,1,0,1
,"",_1222,1,1,1,0,1
,"",_1223,1,1,1,0,1
,"",_1224,1,1,1,0,1
,"",_1225,1,1,1,0,1
,"",_1226,1,1,0,0,0
,"",_1228,1,1,1,0,1
,"",_1229,1,1,1,0,1
,"",_1230,1,1,1,0,1
,"",_1231,1,1,1,0,1
,"",_1232,1,1,1,0,1
,"",_1234,1,1,1,0,1
,"",_1235,1,1,1,0,1
,"",_1236,1,1,1,0,1
,"",_1238,1,1,1,0,1
,"",_1239,1,1,1,0,1
,"",_1240,1,1,1,0,1
,"",_1241,1,1,0,0,0
,"",_1242,1,1,1,0,1
,"",_1243,1,1,1,0,1
,"",_1244,1,1,1,0,1
,"",_1245,1,1,1,0,1
,"",_1246,1,1,1,0,1
,"",_1247,1,1,1,0,1
,"",_1248,1,1,1,0,1
,"",_1249,1,1,1,0,1
,"",_1250,1,1,1,0,1
,"",_1251,1,1,1,0,1
,"",_1252,1,1,1,0,1
,"",_1253,1,1,1,0,1
,"",_1254,1,1,1,0,1
,"",_1255,1,1,1,0,1
,"",_1256,1,1,1,0,1
,"",_1257,1,1,1,0,1
,"",_1258,1,1,1,0,1
,"",_1259,1,1,1,0,1
,"",_1260,1,1,1,0,1
,"",_1261,1,1,1,0,1
,"",_1262,1,1,1,0,1
,"",_1263,1,1,1,0,1
,"",_1264,1,1,1,0,1
,"",_1266,1,1,0,1,1
,"",_1267,1,1,1,0,1
,"",_1268,1,1,1,0,1
,"",_1269,1,1,0,0,0
,"",_1271,1,1,1,0,1
,"",_1272,1,1,1,0,1
,"",_1274,1,1,0,0,0
,"",_1275,1,1,1,0,1
,"",_1276,1,1,1,0,1
,"",_1278,1,1,1,0,1
,"",_1279,1,1,1,0,1
,"",_1280,1,1,1,0,1
,"",_1281,1,1,1,0,1
,"",_1282,1,1,1,0,1
,"",_1283,1,1,1,0,1
,"",_1284,1,1,1,0,1
,"",_1285,1,1,1,0,1
,"",_1287,1,1,1,0,1
,"",_1288,1,1,1,0,1
,"",_1290,1,1,1,0,1
,"",_1291,1,1,1,0,1
,"",_1292,1,1,0,0,0
,"",_1293,1,1,1,0,1
,"",_1295,1,1,1,0,1
,"",_1296,1,1,1,0,1
,"",_1297,1,1,1,0,1
,"",_1298,1,1,0,0,0
,"",_1299,1,1,1,0,1
,"",_1300,1,1,1,0,1
,"",_1301,1,1,1,0,1
,"",_1302,1,1,1,0,1
,"",_1303,1,1,1,0,1
,"",_1304,1,1,1,0,1
,"",_1305,1,1,1,0,1
,"",_1306,1,1,1,0,1
,"",_1307,1,1,0,1,1
,"",_1308,1,1,1,0,1
,"",_1309,1,1,1,0,1
,"",_1310,1,1,1,0,1
,"",_1311,1,1,1,0,1
,"",_1313,1,1,1,0,1
,"",_1314,1,1,1,0,1
,"",_1315,1,1,1,0,1
,"",_1316,1,1,1,0,1

