Name,Description,Combined Group,Unique Machines,Unique UserID, Count F,Count H,EULA Machines
,"",_1,136,129,117,13,130
,"",_2,72,72,31,38,69
NTU,"",_48,65,57,64,0,64
,"",_3,39,37,28,2,30
NYP,"",_36,38,33,35,1,36
,"",_4,38,33,23,4,27
,"",_10,30,27,17,1,18
,"",_7,29,27,15,5,20
,"",_5,28,30,15,5,20
,"",_12,28,27,15,2,17
Unity,"",_6,24,23,11,0,11
,"",_8,23,26,16,1,17
,"",_22,23,16,23,0,23
,"",_13,22,24,16,3,19
,"",_9,19,21,12,2,14
Gumi,"",_21,17,16,4,0,4
Mages,"",_47,16,14,14,0,14
,"",_16,16,17,9,1,10
Temasek Poly,"",_89,15,14,10,1,11
89trillion.com,"",_20,14,15,13,0,13
,"",_11,14,16,7,1,8
,"",_17,14,16,8,2,10
,"",_14,13,11,8,1,9
SIT,"",_73,11,10,10,0,10
,"",_18,11,11,6,2,8
,"",_24,11,10,9,2,11
Koei Tecmo,"",_32,10,10,2,0,2
,"",_15,10,9,5,2,7
,"",_19,10,10,5,0,5
Singapore Poly,"",_51,9,7,9,0,9
NUS,"",_797,9,7,5,0,5
,"",_30,9,9,6,0,6
Tendays Studio / Ignite VR,"",_198,8,7,5,0,5
IGG,"",_39,8,7,1,0,1
,"",_28,8,8,6,1,7
,"",_29,8,8,4,4,8
,"",_31,7,7,6,0,6
,"",_38,7,6,7,0,7
SUTD,"",_462,6,6,6,0,6
Singapore Poly / Chesterfield,"http://chesterfield.sg/
Singapore Polytechnic
",_395,6,6,5,0,5
Mighty Bear,"",_134,6,5,2,0,2
Hiverlab,"https://www.hiverlab.com/
",_203,6,4,1,0,1
Electricsquare,"",_61,6,6,1,0,1
,"",_25,6,6,3,1,4
,"",_37,6,6,6,0,6
Yoozoo games,"https://global.yoozoo.com/news/7000056.html
",_179,5,4,5,0,5
Azurite,"",_149,5,4,4,0,4
,"",_34,5,5,5,0,5
,"",_35,5,5,5,0,5
,"",_46,5,5,5,0,5
White Label Studio,"https://whitelabelstudio.global/
",_144,4,3,4,0,4
VR Collab,"",_319,4,3,0,0,0
Swagsoft,"",_335,4,4,2,0,2
Singnet,"",_81,4,1,4,0,4
SideFX Studios,"https://genesis.hq.unity3d.com/organizations/1374436136701/
",_44,4,4,0,0,0
Royce Media,"",_147,4,3,4,0,4
Marina Bay Sands,"sinonet3d@gmail.com
https://genesis.hq.unity3d.com/organizations/18966836212561/
millernguyen.mbs@gmail.com
liulink@gmail.com
",_145,4,2,4,0,4
Land Shark Games,"",_304,4,4,0,0,0
GovTech,"rayjue99@hotmail.com
hazel77744@gmail.com
",_300,4,3,2,0,2
Autumn Interactive,"",_868,4,4,3,0,3
,"",_45,4,4,3,0,3
,"",_67,4,4,4,0,4
,"",_91,4,3,3,0,3
StarSprite,"http://starsprite.com/
",_204,3,2,2,0,2
Silversea Media,"https://www.silversea-media.com/
",_870,3,2,0,3,3
Revez Digital,"http://revezdigital.com/
Plus license
",_166,3,3,3,0,3
PlayTech Studio,"",_77,3,2,3,0,3
Meshtint,"",_1304,3,2,3,0,3
Korea user,"",_132,3,2,2,0,2
DSO HEDP,"",_254,3,3,3,0,3
Anacle,"",_325,3,3,2,0,2
,"",_52,3,2,3,0,3
,"",_57,3,2,1,0,1
,"",_76,3,3,3,0,3
,"",_82,3,3,3,0,3
,"",_85,3,2,1,0,1
,"",_90,3,3,3,0,3
,"",_94,3,2,3,0,3
,"",_101,3,3,3,0,3
,"",_102,3,3,3,0,3
,"",_112,3,2,3,0,3
,"",_117,3,3,3,0,3
,"",_125,3,1,3,0,3
,"",_126,3,3,3,0,3
,"",_148,3,2,3,0,3
,"",_425,3,2,3,0,3
Vincent Goh,"",_810,2,2,2,0,2
The iterative Collective,"https://theiterative.co/
",_152,2,2,2,0,2
ST Engineering Land Systems,"",_649,2,1,1,0,1
Presence Pictures VR,"https://app.presencepictures.com.sg/storePages/presenceImages/PresencePicturesAboutUs.pdf#toolbar=0&navpanes=0&scrollbar=0
",_694,2,1,1,0,1
Pangaea Interactive,"https://genesis.hq.unity3d.com/organizations/18966656267336/
http://pangaeainteractive.com/
",_74,2,1,1,0,1
Orca Studios,"",_211,2,2,0,0,0
NUS Engineering Design and Innovation Centre,"",_291,2,2,1,0,1
New Future Games,"",_225,2,1,2,0,2
Mersiva LLP / Iceberg Design,"",_306,2,2,2,0,2
Make Studios,"",_444,2,1,2,0,2
iShorty,"",_106,2,2,2,0,2
https://www.xiibraves.com/,"Org with 11 members
",_437,2,2,0,0,0
Exousia Studios,"",_191,2,2,2,0,2
EON Reality,"",_133,2,2,0,0,0
Bui_Thanh (VN),"",_278,2,2,0,2,2
Aviationlearn.com,"",_213,2,2,1,0,1
Aviation Virtual,"",_659,2,2,1,0,1
A-Star,"https://genesis.hq.unity3d.com/organizations/18966615602330/
",_382,2,3,2,0,2
,"",_33,2,1,2,0,2
,"",_40,2,2,2,0,2
,"",_41,2,1,2,0,2
,"",_43,2,2,2,0,2
,"",_49,2,2,2,0,2
,"",_54,2,2,2,0,2
,"",_55,2,1,2,0,2
,"",_58,2,1,2,0,2
,"",_60,2,1,2,0,2
,"",_63,2,1,2,0,2
,"",_64,2,2,0,0,0
,"",_78,2,1,2,0,2
,"",_79,2,1,2,0,2
,"",_80,2,2,2,0,2
,"",_83,2,2,1,1,2
,"",_87,2,2,2,0,2
,"",_88,2,2,2,0,2
,"",_92,2,2,1,1,2
,"",_93,2,2,1,0,1
,"",_96,2,2,1,0,1
,"",_105,2,1,2,0,2
,"",_107,2,1,2,0,2
,"",_110,2,1,2,0,2
,"",_111,2,1,2,0,2
,"",_114,2,1,2,0,2
,"",_115,2,1,2,0,2
,"",_122,2,2,0,2,2
,"",_123,2,2,2,0,2
,"",_127,2,2,0,2,2
,"",_129,2,2,2,0,2
,"",_130,2,2,2,0,2
,"",_131,2,2,2,0,2
,"",_135,2,2,2,0,2
,"",_146,2,1,2,0,2
,"",_150,2,1,2,0,2
,"",_157,2,1,2,0,2
,"",_160,2,2,2,0,2
,"",_161,2,1,2,0,2
,"",_168,2,1,2,0,2
,"",_171,2,1,2,0,2
,"",_172,2,2,2,0,2
,"",_196,2,2,2,0,2
,"",_207,2,2,2,0,2
,"",_209,2,2,2,0,2
,"",_210,2,2,2,0,2
,"",_214,2,1,2,0,2
,"",_217,2,1,2,0,2
,"",_220,2,1,2,0,2
,"",_236,2,2,2,0,2
,"",_237,2,2,1,0,1
,"",_238,2,2,2,0,2
,"",_244,2,1,2,0,2
,"",_250,2,2,1,0,1
,"",_251,2,2,2,0,2
,"",_261,2,2,2,0,2
,"",_270,2,1,2,0,2
,"",_272,2,2,2,0,2
,"",_277,2,2,2,0,2
,"",_295,2,2,2,0,2
,"",_299,2,2,2,0,2
,"",_302,2,2,2,0,2
,"",_307,2,1,2,0,2
,"",_308,2,2,2,0,2
,"",_314,2,1,2,0,2
,"",_320,2,2,2,0,2
,"",_330,2,1,2,0,2
,"",_333,2,1,1,0,1
,"",_340,2,1,1,0,1
,"",_349,2,2,2,0,2
,"",_352,2,1,2,0,2
,"",_355,2,1,0,0,0
,"",_356,2,1,2,0,2
,"",_365,2,1,2,0,2
,"",_370,2,1,2,0,2
,"",_373,2,1,2,0,2
,"",_374,2,1,2,0,2
,"",_375,2,2,2,0,2
,"",_380,2,1,2,0,2
,"",_381,2,2,2,0,2
,"",_383,2,1,2,0,2
,"",_399,2,2,2,0,2
,"",_401,2,1,2,0,2
,"",_402,2,2,0,0,0
,"",_407,2,2,2,0,2
,"",_408,2,1,0,0,0
,"",_409,2,2,2,0,2
,"",_410,2,1,2,0,2
,"",_413,2,1,2,0,2
,"",_414,2,2,2,0,2
,"",_416,2,2,1,0,1
,"",_422,2,1,2,0,2
,"",_598,2,1,2,0,2
,"",_710,2,1,0,0,0
,"",_978,2,1,2,0,2
,"",_1012,2,1,2,0,2
,"",_1096,2,1,2,0,2
,"",_1131,2,1,2,0,2
,"",_1220,2,1,0,0,0
Vividthree,"",_1067,1,1,0,0,0
Visenze,"",_471,1,1,1,0,1
Ubisoft,"https://genesis.hq.unity3d.com/users/20066241185396/
",_709,1,1,0,0,0
Tuxedo Cow,"",_480,1,1,0,0,0
Trinax,"",_742,1,1,0,0,0
The Carrot Studio,"",_72,1,1,1,0,1
Terresqual,"",_100,1,1,1,0,1
Taggle Health,"",_1395,1,1,0,0,0
STE Training & Simulation,"leong.guowei@stengg.com	
liew.wanhui@stee.stengg.com
kohwuisiong2@gmail.com
",_97,1,1,1,0,1
Starstruck Games,"",_716,1,1,1,0,1
Singapore American School,"",_1426,1,1,1,0,1
Siemens - Lim Riqui,"https://genesis.hq.unity3d.com/users/18966804306463/
",_849,1,1,1,0,1
Shadowbyte Games,"",_1172,1,1,0,0,0
Pern Jie,"",_548,1,1,1,0,1
NTU VR Lab,"",_174,1,1,1,0,1
Nanyang Poly,"",_828,1,1,0,0,0
ITE,"",_938,1,1,1,0,1
Hennery Studio,"",_1155,1,1,1,0,1
Cybervision,"",_441,1,1,1,0,1
Brandon Gui,"",_136,1,1,0,0,0
AAT Training Hub,"",_158,1,1,0,0,0
,"",_26,1,1,1,0,1
,"",_27,1,2,1,0,1
,"",_42,1,1,1,0,1
,"",_53,1,1,1,0,1
,"",_56,1,2,1,0,1
,"",_59,1,1,1,0,1
,"",_62,1,1,1,0,1
,"",_65,1,1,1,0,1
,"",_68,1,1,1,0,1
,"",_69,1,1,1,0,1
,"",_70,1,1,1,0,1
,"",_71,1,1,1,0,1
,"",_75,1,1,1,0,1
,"",_95,1,1,1,0,1
,"",_98,1,1,1,0,1
,"",_99,1,1,1,0,1
,"",_103,1,2,1,0,1
,"",_108,1,1,0,0,0
,"",_109,1,1,0,0,0
,"",_113,1,1,1,0,1
,"",_119,1,1,1,0,1
,"",_120,1,1,0,0,0
,"",_121,1,1,1,0,1
,"",_124,1,1,1,0,1
,"",_128,1,1,0,0,0
,"",_137,1,1,1,0,1
,"",_138,1,1,1,0,1
,"",_139,1,1,1,0,1
,"",_140,1,1,1,0,1
,"",_141,1,1,1,0,1
,"",_142,1,1,1,0,1
,"",_143,1,1,0,0,0
,"",_151,1,1,1,0,1
,"",_153,1,1,1,0,1
,"",_154,1,1,1,0,1
,"",_155,1,1,1,0,1
,"",_156,1,1,1,0,1
,"",_159,1,1,1,0,1
,"",_162,1,1,1,0,1
,"",_163,1,1,1,0,1
,"",_164,1,1,1,0,1
,"",_165,1,1,1,0,1
,"",_167,1,1,1,0,1
,"",_169,1,1,1,0,1
,"",_170,1,1,1,0,1
,"",_173,1,1,1,0,1
,"",_175,1,1,1,0,1
,"",_176,1,1,1,0,1
,"",_177,1,1,1,0,1
,"",_178,1,1,1,0,1
,"",_180,1,1,1,0,1
,"",_181,1,1,1,0,1
,"",_182,1,1,1,0,1
,"",_183,1,1,1,0,1
,"",_184,1,1,1,0,1
,"",_185,1,1,1,0,1
,"",_186,1,1,1,0,1
,"",_188,1,1,1,0,1
,"",_190,1,1,1,0,1
,"",_192,1,1,0,0,0
,"",_193,1,1,1,0,1
,"",_194,1,1,1,0,1
,"",_195,1,1,1,0,1
,"",_197,1,1,1,0,1
,"",_199,1,1,1,0,1
,"",_200,1,1,1,0,1
,"",_201,1,2,1,0,1
,"",_202,1,1,1,0,1
,"",_206,1,1,1,0,1
,"",_212,1,1,1,0,1
,"",_215,1,1,0,0,0
,"",_218,1,1,1,0,1
,"",_219,1,1,1,0,1
,"",_221,1,1,1,0,1
,"",_222,1,1,1,0,1
,"",_223,1,1,1,0,1
,"",_224,1,1,1,0,1
,"",_226,1,1,1,0,1
,"",_227,1,1,1,0,1
,"",_228,1,1,1,0,1
,"",_230,1,1,1,0,1
,"",_231,1,1,1,0,1
,"",_232,1,2,1,0,1
,"",_233,1,1,1,0,1
,"",_235,1,1,1,0,1
,"",_239,1,1,1,0,1
,"",_241,1,1,1,0,1
,"",_242,1,1,1,0,1
,"",_243,1,1,1,0,1
,"",_245,1,1,1,0,1
,"",_246,1,1,1,0,1
,"",_247,1,1,1,0,1
,"",_248,1,1,1,0,1
,"",_249,1,1,1,0,1
,"",_252,1,1,1,0,1
,"",_253,1,1,0,0,0
,"",_256,1,1,1,0,1
,"",_257,1,1,1,0,1
,"",_258,1,1,1,0,1
,"",_259,1,1,1,0,1
,"",_262,1,1,1,0,1
,"",_263,1,1,1,0,1
,"",_264,1,1,1,0,1
,"",_265,1,1,1,0,1
,"",_266,1,1,1,0,1
,"",_267,1,1,1,0,1
,"",_268,1,1,1,0,1
,"",_269,1,1,1,0,1
,"",_271,1,1,0,1,1
,"",_273,1,1,1,0,1
,"",_274,1,1,1,0,1
,"",_275,1,2,0,0,0
,"",_280,1,1,1,0,1
,"",_281,1,1,1,0,1
,"",_282,1,1,1,0,1
,"",_283,1,1,1,0,1
,"",_285,1,1,0,0,0
,"",_286,1,1,1,0,1
,"",_287,1,1,0,0,0
,"",_288,1,1,1,0,1
,"",_289,1,1,1,0,1
,"",_290,1,1,1,0,1
,"",_292,1,1,1,0,1
,"",_293,1,1,0,1,1
,"",_294,1,1,0,0,0
,"",_296,1,1,1,0,1
,"",_297,1,1,1,0,1
,"",_298,1,1,1,0,1
,"",_301,1,1,1,0,1
,"",_303,1,1,1,0,1
,"",_309,1,1,1,0,1
,"",_310,1,1,1,0,1
,"",_311,1,1,1,0,1
,"",_312,1,1,1,0,1
,"",_313,1,1,1,0,1
,"",_315,1,1,1,0,1
,"",_316,1,1,1,0,1
,"",_317,1,2,1,0,1
,"",_318,1,1,1,0,1
,"",_321,1,1,1,0,1
,"",_322,1,1,1,0,1
,"",_324,1,1,1,0,1
,"",_326,1,2,1,0,1
,"",_327,1,1,0,1,1
,"",_328,1,1,1,0,1
,"",_331,1,1,0,1,1
,"",_332,1,1,1,0,1
,"",_334,1,1,1,0,1
,"",_336,1,1,0,0,0
,"",_337,1,1,1,0,1
,"",_338,1,1,1,0,1
,"",_339,1,1,1,0,1
,"",_342,1,1,1,0,1
,"",_343,1,1,1,0,1
,"",_344,1,1,1,0,1
,"",_345,1,1,1,0,1
,"",_346,1,1,1,0,1
,"",_347,1,1,1,0,1
,"",_348,1,1,1,0,1
,"",_350,1,1,1,0,1
,"",_351,1,1,1,0,1
,"",_353,1,1,1,0,1
,"",_354,1,1,1,0,1
,"",_358,1,1,1,0,1
,"",_359,1,1,1,0,1
,"",_360,1,1,1,0,1
,"",_362,1,1,1,0,1
,"",_363,1,1,1,0,1
,"",_364,1,2,1,0,1
,"",_366,1,1,1,0,1
,"",_367,1,1,0,0,0
,"",_368,1,1,0,0,0
,"",_376,1,1,1,0,1
,"",_377,1,1,1,0,1
,"",_378,1,1,1,0,1
,"",_379,1,1,1,0,1
,"",_384,1,1,1,0,1
,"",_385,1,1,1,0,1
,"",_386,1,1,1,0,1
,"",_387,1,1,1,0,1
,"",_388,1,1,1,0,1
,"",_389,1,1,1,0,1
,"",_390,1,1,1,0,1
,"",_392,1,1,1,0,1
,"",_394,1,1,1,0,1
,"",_396,1,1,1,0,1
,"",_397,1,1,1,0,1
,"",_400,1,1,1,0,1
,"",_403,1,1,1,0,1
,"",_404,1,1,1,0,1
,"",_405,1,1,0,0,0
,"",_411,1,1,1,0,1
,"",_412,1,1,1,0,1
,"",_417,1,1,1,0,1
,"",_418,1,1,1,0,1
,"",_419,1,1,1,0,1
,"",_423,1,1,0,0,0
,"",_424,1,1,1,0,1
,"",_426,1,1,0,0,0
,"",_427,1,1,1,0,1
,"",_428,1,1,1,0,1
,"",_429,1,1,1,0,1
,"",_430,1,1,1,0,1
,"",_431,1,1,0,0,0
,"",_432,1,1,1,0,1
,"",_433,1,1,1,0,1
,"",_434,1,1,0,1,1
,"",_436,1,1,1,0,1
,"",_438,1,1,1,0,1
,"",_439,1,1,1,0,1
,"",_440,1,1,1,0,1
,"",_442,1,1,0,0,0
,"",_443,1,1,1,0,1
,"",_445,1,1,1,0,1
,"",_446,1,1,1,0,1
,"",_447,1,1,1,0,1
,"",_448,1,1,1,0,1
,"",_449,1,1,1,0,1
,"",_450,1,1,1,0,1
,"",_451,1,1,1,0,1
,"",_452,1,1,1,0,1
,"",_453,1,1,1,0,1
,"",_454,1,1,1,0,1
,"",_455,1,1,1,0,1
,"",_456,1,1,1,0,1
,"",_457,1,1,1,0,1
,"",_458,1,1,1,0,1
,"",_460,1,1,1,0,1
,"",_461,1,1,1,0,1
,"",_463,1,1,1,0,1
,"",_464,1,1,1,0,1
,"",_465,1,1,1,0,1
,"",_466,1,1,1,0,1
,"",_467,1,1,1,0,1
,"",_468,1,1,1,0,1
,"",_469,1,1,1,0,1
,"",_470,1,1,1,0,1
,"",_472,1,1,1,0,1
,"",_473,1,1,1,0,1
,"",_474,1,1,1,0,1
,"",_475,1,1,1,0,1
,"",_476,1,1,1,0,1
,"",_477,1,1,1,0,1
,"",_478,1,1,1,0,1
,"",_479,1,1,1,0,1
,"",_481,1,1,1,0,1
,"",_482,1,1,1,0,1
,"",_483,1,1,1,0,1
,"",_484,1,1,1,0,1
,"",_485,1,1,1,0,1
,"",_486,1,1,0,1,1
,"",_488,1,1,1,0,1
,"",_489,1,1,1,0,1
,"",_490,1,1,1,0,1
,"",_492,1,1,1,0,1
,"",_493,1,1,1,0,1
,"",_494,1,1,1,0,1
,"",_495,1,1,1,0,1
,"",_496,1,1,1,0,1
,"",_497,1,1,1,0,1
,"",_498,1,1,1,0,1
,"",_499,1,1,1,0,1
,"",_500,1,1,1,0,1
,"",_501,1,1,1,0,1
,"",_502,1,1,1,0,1
,"",_503,1,1,1,0,1
,"",_504,1,1,1,0,1
,"",_505,1,1,1,0,1
,"",_506,1,1,1,0,1
,"",_507,1,1,1,0,1
,"",_508,1,1,1,0,1
,"",_509,1,1,1,0,1
,"",_510,1,1,1,0,1
,"",_511,1,1,1,0,1
,"",_512,1,1,1,0,1
,"",_513,1,1,1,0,1
,"",_514,1,1,1,0,1
,"",_515,1,1,1,0,1
,"",_516,1,1,0,1,1
,"",_517,1,1,1,0,1
,"",_518,1,1,1,0,1
,"",_519,1,1,1,0,1
,"",_520,1,1,1,0,1
,"",_521,1,1,1,0,1
,"",_522,1,1,1,0,1
,"",_523,1,1,1,0,1
,"",_524,1,1,1,0,1
,"",_525,1,1,1,0,1
,"",_526,1,1,1,0,1
,"",_527,1,1,0,1,1
,"",_528,1,1,1,0,1
,"",_529,1,1,1,0,1
,"",_531,1,1,1,0,1
,"",_532,1,1,0,0,0
,"",_533,1,1,1,0,1
,"",_534,1,1,1,0,1
,"",_535,1,1,1,0,1
,"",_536,1,1,1,0,1
,"",_537,1,1,1,0,1
,"",_538,1,1,1,0,1
,"",_540,1,1,1,0,1
,"",_542,1,1,1,0,1
,"",_543,1,1,1,0,1
,"",_544,1,1,1,0,1
,"",_545,1,1,1,0,1
,"",_546,1,1,1,0,1
,"",_547,1,1,1,0,1
,"",_549,1,1,1,0,1
,"",_550,1,1,1,0,1
,"",_551,1,1,1,0,1
,"",_552,1,1,1,0,1
,"",_553,1,1,1,0,1
,"",_554,1,1,1,0,1
,"",_555,1,1,1,0,1
,"",_556,1,1,1,0,1
,"",_557,1,1,0,0,0
,"",_558,1,1,1,0,1
,"",_559,1,1,1,0,1
,"",_560,1,1,1,0,1
,"",_561,1,1,1,0,1
,"",_562,1,1,1,0,1
,"",_563,1,1,1,0,1
,"",_564,1,1,1,0,1
,"",_565,1,1,1,0,1
,"",_566,1,1,1,0,1
,"",_567,1,1,0,1,1
,"",_568,1,1,1,0,1
,"",_569,1,1,1,0,1
,"",_570,1,1,1,0,1
,"",_571,1,1,1,0,1
,"",_572,1,1,1,0,1
,"",_573,1,1,1,0,1
,"",_574,1,1,1,0,1
,"",_575,1,1,1,0,1
,"",_576,1,1,1,0,1
,"",_577,1,1,1,0,1
,"",_578,1,1,1,0,1
,"",_579,1,1,1,0,1
,"",_580,1,1,1,0,1
,"",_581,1,1,1,0,1
,"",_584,1,1,1,0,1
,"",_585,1,1,1,0,1
,"",_587,1,1,1,0,1
,"",_589,1,1,1,0,1
,"",_590,1,1,1,0,1
,"",_591,1,1,1,0,1
,"",_592,1,1,1,0,1
,"",_593,1,1,1,0,1
,"",_594,1,1,1,0,1
,"",_595,1,1,1,0,1
,"",_596,1,1,1,0,1
,"",_597,1,1,1,0,1
,"",_599,1,1,1,0,1
,"",_600,1,1,1,0,1
,"",_601,1,1,1,0,1
,"",_602,1,1,1,0,1
,"",_603,1,1,1,0,1
,"",_604,1,1,1,0,1
,"",_605,1,1,1,0,1
,"",_606,1,1,1,0,1
,"",_607,1,1,1,0,1
,"",_608,1,1,1,0,1
,"",_609,1,1,1,0,1
,"",_610,1,1,1,0,1
,"",_611,1,1,1,0,1
,"",_612,1,1,1,0,1
,"",_614,1,1,1,0,1
,"",_615,1,1,1,0,1
,"",_616,1,1,0,0,0
,"",_617,1,1,1,0,1
,"",_618,1,1,1,0,1
,"",_620,1,1,1,0,1
,"",_624,1,1,1,0,1
,"",_625,1,1,1,0,1
,"",_626,1,1,1,0,1
,"",_627,1,1,1,0,1
,"",_629,1,1,1,0,1
,"",_630,1,1,1,0,1
,"",_631,1,1,1,0,1
,"",_632,1,1,1,0,1
,"",_633,1,1,1,0,1
,"",_634,1,1,1,0,1
,"",_635,1,1,1,0,1
,"",_636,1,1,1,0,1
,"",_637,1,1,1,0,1
,"",_638,1,1,1,0,1
,"",_639,1,1,1,0,1
,"",_640,1,1,1,0,1
,"",_641,1,1,1,0,1
,"",_642,1,1,1,0,1
,"",_644,1,1,1,0,1
,"",_646,1,1,1,0,1
,"",_647,1,1,0,0,0
,"",_648,1,1,1,0,1
,"",_651,1,1,1,0,1
,"",_652,1,1,1,0,1
,"",_653,1,1,1,0,1
,"",_654,1,1,1,0,1
,"",_655,1,1,1,0,1
,"",_656,1,1,1,0,1
,"",_657,1,1,1,0,1
,"",_660,1,1,1,0,1
,"",_661,1,1,1,0,1
,"",_662,1,1,1,0,1
,"",_663,1,1,1,0,1
,"",_664,1,1,1,0,1
,"",_665,1,1,1,0,1
,"",_666,1,1,1,0,1
,"",_667,1,1,1,0,1
,"",_668,1,1,1,0,1
,"",_669,1,1,1,0,1
,"",_670,1,1,1,0,1
,"",_672,1,1,1,0,1
,"",_675,1,1,1,0,1
,"",_678,1,1,1,0,1
,"",_679,1,1,1,0,1
,"",_680,1,1,1,0,1
,"",_681,1,1,1,0,1
,"",_682,1,1,1,0,1
,"",_683,1,1,1,0,1
,"",_684,1,1,1,0,1
,"",_685,1,1,0,0,0
,"",_686,1,1,1,0,1
,"",_687,1,1,0,0,0
,"",_688,1,1,1,0,1
,"",_689,1,1,0,0,0
,"",_690,1,1,1,0,1
,"",_691,1,1,1,0,1
,"",_692,1,1,1,0,1
,"",_693,1,1,1,0,1
,"",_695,1,1,1,0,1
,"",_697,1,1,1,0,1
,"",_698,1,1,1,0,1
,"",_699,1,1,0,0,0
,"",_700,1,1,0,0,0
,"",_701,1,1,1,0,1
,"",_702,1,1,1,0,1
,"",_703,1,1,1,0,1
,"",_704,1,1,1,0,1
,"",_705,1,1,1,0,1
,"",_706,1,1,1,0,1
,"",_707,1,1,1,0,1
,"",_708,1,1,1,0,1
,"",_711,1,1,1,0,1
,"",_712,1,1,1,0,1
,"",_713,1,1,1,0,1
,"",_715,1,1,0,0,0
,"",_717,1,1,1,0,1
,"",_718,1,1,1,0,1
,"",_719,1,1,1,0,1
,"",_720,1,1,1,0,1
,"",_721,1,1,1,0,1
,"",_722,1,1,1,0,1
,"",_723,1,1,1,0,1
,"",_724,1,1,0,0,0
,"",_725,1,1,0,0,0
,"",_726,1,1,1,0,1
,"",_729,1,1,1,0,1
,"",_730,1,1,1,0,1
,"",_731,1,1,1,0,1
,"",_732,1,1,1,0,1
,"",_733,1,1,1,0,1
,"",_734,1,1,1,0,1
,"",_735,1,1,1,0,1
,"",_736,1,1,0,1,1
,"",_737,1,1,1,0,1
,"",_738,1,1,0,0,0
,"",_739,1,1,1,0,1
,"",_740,1,1,1,0,1
,"",_741,1,1,1,0,1
,"",_743,1,1,1,0,1
,"",_744,1,1,1,0,1
,"",_745,1,1,1,0,1
,"",_748,1,1,1,0,1
,"",_749,1,1,1,0,1
,"",_750,1,1,1,0,1
,"",_751,1,1,1,0,1
,"",_752,1,1,1,0,1
,"",_753,1,1,1,0,1
,"",_755,1,1,1,0,1
,"",_756,1,1,1,0,1
,"",_757,1,1,1,0,1
,"",_758,1,1,1,0,1
,"",_759,1,1,1,0,1
,"",_760,1,1,0,1,1
,"",_761,1,1,1,0,1
,"",_762,1,1,1,0,1
,"",_763,1,1,1,0,1
,"",_764,1,1,1,0,1
,"",_765,1,1,1,0,1
,"",_766,1,1,1,0,1
,"",_767,1,1,1,0,1
,"",_768,1,1,1,0,1
,"",_770,1,1,1,0,1
,"",_771,1,1,1,0,1
,"",_772,1,1,1,0,1
,"",_773,1,1,0,1,1
,"",_774,1,1,1,0,1
,"",_776,1,1,1,0,1
,"",_777,1,1,1,0,1
,"",_778,1,1,1,0,1
,"",_779,1,1,1,0,1
,"",_780,1,1,1,0,1
,"",_781,1,1,1,0,1
,"",_782,1,1,1,0,1
,"",_783,1,1,1,0,1
,"",_784,1,1,1,0,1
,"",_785,1,1,1,0,1
,"",_786,1,1,1,0,1
,"",_787,1,1,1,0,1
,"",_788,1,1,1,0,1
,"",_789,1,1,1,0,1
,"",_790,1,1,1,0,1
,"",_792,1,1,1,0,1
,"",_793,1,1,1,0,1
,"",_794,1,1,1,0,1
,"",_795,1,1,1,0,1
,"",_798,1,1,1,0,1
,"",_799,1,1,1,0,1
,"",_800,1,1,1,0,1
,"",_801,1,1,1,0,1
,"",_802,1,1,1,0,1
,"",_803,1,1,1,0,1
,"",_804,1,1,0,0,0
,"",_805,1,1,1,0,1
,"",_806,1,1,1,0,1
,"",_808,1,1,1,0,1
,"",_809,1,1,1,0,1
,"",_811,1,1,1,0,1
,"",_812,1,1,1,0,1
,"",_813,1,1,1,0,1
,"",_814,1,1,1,0,1
,"",_815,1,1,1,0,1
,"",_816,1,1,1,0,1
,"",_817,1,1,1,0,1
,"",_818,1,1,1,0,1
,"",_819,1,1,1,0,1
,"",_821,1,1,1,0,1
,"",_822,1,1,1,0,1
,"",_823,1,1,0,0,0
,"",_825,1,1,1,0,1
,"",_827,1,1,1,0,1
,"",_830,1,1,1,0,1
,"",_831,1,1,1,0,1
,"",_833,1,1,1,0,1
,"",_834,1,1,1,0,1
,"",_835,1,1,1,0,1
,"",_836,1,1,1,0,1
,"",_837,1,1,1,0,1
,"",_838,1,1,1,0,1
,"",_839,1,1,1,0,1
,"",_840,1,1,1,0,1
,"",_841,1,1,1,0,1
,"",_842,1,1,0,0,0
,"",_843,1,1,1,0,1
,"",_844,1,1,1,0,1
,"",_845,1,1,1,0,1
,"",_846,1,1,1,0,1
,"",_848,1,1,1,0,1
,"",_850,1,1,1,0,1
,"",_851,1,1,1,0,1
,"",_852,1,1,1,0,1
,"",_853,1,1,1,0,1
,"",_854,1,1,1,0,1
,"",_855,1,1,1,0,1
,"",_856,1,1,1,0,1
,"",_857,1,1,1,0,1
,"",_858,1,1,0,0,0
,"",_859,1,1,0,0,0
,"",_860,1,1,1,0,1
,"",_861,1,1,1,0,1
,"",_862,1,1,1,0,1
,"",_863,1,1,1,0,1
,"",_864,1,1,1,0,1
,"",_865,1,1,1,0,1
,"",_866,1,1,1,0,1
,"",_867,1,1,1,0,1
,"",_869,1,1,1,0,1
,"",_871,1,1,1,0,1
,"",_872,1,1,1,0,1
,"",_873,1,1,1,0,1
,"",_874,1,1,1,0,1
,"",_875,1,1,1,0,1
,"",_876,1,1,1,0,1
,"",_877,1,1,1,0,1
,"",_879,1,1,1,0,1
,"",_880,1,1,1,0,1
,"",_881,1,1,1,0,1
,"",_882,1,1,1,0,1
,"",_883,1,1,1,0,1
,"",_884,1,1,1,0,1
,"",_885,1,1,1,0,1
,"",_886,1,1,1,0,1
,"",_887,1,1,1,0,1
,"",_888,1,1,1,0,1
,"",_889,1,1,1,0,1
,"",_890,1,1,1,0,1
,"",_891,1,1,1,0,1
,"",_892,1,1,1,0,1
,"",_893,1,1,0,0,0
,"",_894,1,1,1,0,1
,"",_896,1,1,1,0,1
,"",_897,1,1,0,0,0
,"",_898,1,1,1,0,1
,"",_899,1,1,1,0,1
,"",_900,1,1,1,0,1
,"",_901,1,1,1,0,1
,"",_902,1,1,1,0,1
,"",_903,1,1,1,0,1
,"",_904,1,1,1,0,1
,"",_905,1,1,1,0,1
,"",_906,1,1,1,0,1
,"",_907,1,1,1,0,1
,"",_908,1,1,1,0,1
,"",_909,1,1,1,0,1
,"",_910,1,1,1,0,1
,"",_911,1,1,1,0,1
,"",_912,1,1,1,0,1
,"",_913,1,1,1,0,1
,"",_914,1,1,1,0,1
,"",_915,1,1,1,0,1
,"",_917,1,1,1,0,1
,"",_918,1,1,1,0,1
,"",_919,1,1,1,0,1
,"",_920,1,1,1,0,1
,"",_921,1,1,1,0,1
,"",_922,1,1,1,0,1
,"",_923,1,1,1,0,1
,"",_924,1,1,1,0,1
,"",_927,1,1,1,0,1
,"",_928,1,1,1,0,1
,"",_929,1,1,1,0,1
,"",_930,1,1,1,0,1
,"",_931,1,1,1,0,1
,"",_933,1,1,1,0,1
,"",_934,1,1,1,0,1
,"",_935,1,1,1,0,1
,"",_936,1,1,1,0,1
,"",_937,1,1,1,0,1
,"",_939,1,1,1,0,1
,"",_940,1,1,1,0,1
,"",_941,1,1,1,0,1
,"",_942,1,1,1,0,1
,"",_943,1,1,1,0,1
,"",_944,1,1,1,0,1
,"",_945,1,1,1,0,1
,"",_946,1,1,1,0,1
,"",_947,1,1,1,0,1
,"",_948,1,1,1,0,1
,"",_949,1,1,1,0,1
,"",_952,1,1,1,0,1
,"",_953,1,1,1,0,1
,"",_954,1,1,1,0,1
,"",_955,1,1,0,0,0
,"",_957,1,1,1,0,1
,"",_958,1,1,1,0,1
,"",_959,1,1,1,0,1
,"",_960,1,1,1,0,1
,"",_962,1,1,1,0,1
,"",_963,1,1,1,0,1
,"",_964,1,1,1,0,1
,"",_965,1,1,1,0,1
,"",_966,1,1,1,0,1
,"",_967,1,1,1,0,1
,"",_968,1,1,1,0,1
,"",_969,1,1,1,0,1
,"",_970,1,1,1,0,1
,"",_971,1,1,1,0,1
,"",_972,1,1,1,0,1
,"",_973,1,1,1,0,1
,"",_974,1,1,0,1,1
,"",_975,1,1,1,0,1
,"",_976,1,1,1,0,1
,"",_977,1,1,1,0,1
,"",_979,1,1,1,0,1
,"",_980,1,1,1,0,1
,"",_981,1,1,1,0,1
,"",_982,1,1,1,0,1
,"",_983,1,1,0,1,1
,"",_984,1,1,1,0,1
,"",_985,1,1,1,0,1
,"",_986,1,1,0,0,0
,"",_987,1,1,1,0,1
,"",_988,1,1,1,0,1
,"",_989,1,1,1,0,1
,"",_990,1,1,1,0,1
,"",_991,1,1,1,0,1
,"",_992,1,1,0,1,1
,"",_993,1,1,1,0,1
,"",_994,1,1,1,0,1
,"",_995,1,1,0,0,0
,"",_996,1,1,1,0,1
,"",_999,1,1,1,0,1
,"",_1000,1,1,1,0,1
,"",_1001,1,1,1,0,1
,"",_1003,1,1,1,0,1
,"",_1004,1,1,1,0,1
,"",_1006,1,1,1,0,1
,"",_1007,1,1,1,0,1
,"",_1008,1,1,1,0,1
,"",_1009,1,1,1,0,1
,"",_1010,1,1,1,0,1
,"",_1011,1,1,1,0,1
,"",_1013,1,1,0,0,0
,"",_1014,1,1,1,0,1
,"",_1016,1,1,1,0,1
,"",_1017,1,1,1,0,1
,"",_1018,1,1,1,0,1
,"",_1019,1,1,1,0,1
,"",_1020,1,1,1,0,1
,"",_1021,1,1,1,0,1
,"",_1022,1,1,1,0,1
,"",_1024,1,1,1,0,1
,"",_1025,1,1,1,0,1
,"",_1026,1,1,1,0,1
,"",_1027,1,1,1,0,1
,"",_1028,1,1,1,0,1
,"",_1029,1,1,1,0,1
,"",_1030,1,1,1,0,1
,"",_1031,1,1,1,0,1
,"",_1032,1,1,0,0,0
,"",_1034,1,1,1,0,1
,"",_1036,1,1,1,0,1
,"",_1037,1,1,1,0,1
,"",_1038,1,1,1,0,1
,"",_1039,1,1,1,0,1
,"",_1040,1,1,1,0,1
,"",_1042,1,1,1,0,1
,"",_1043,1,1,1,0,1
,"",_1044,1,1,1,0,1
,"",_1045,1,1,1,0,1
,"",_1046,1,1,1,0,1
,"",_1048,1,1,1,0,1
,"",_1050,1,1,1,0,1
,"",_1051,1,1,1,0,1
,"",_1052,1,1,1,0,1
,"",_1053,1,1,1,0,1
,"",_1054,1,1,1,0,1
,"",_1055,1,1,1,0,1
,"",_1056,1,1,1,0,1
,"",_1057,1,1,1,0,1
,"",_1058,1,1,1,0,1
,"",_1059,1,1,1,0,1
,"",_1060,1,1,1,0,1
,"",_1061,1,1,1,0,1
,"",_1062,1,1,1,0,1
,"",_1063,1,1,1,0,1
,"",_1064,1,1,1,0,1
,"",_1065,1,1,1,0,1
,"",_1068,1,1,1,0,1
,"",_1069,1,1,1,0,1
,"",_1070,1,1,1,0,1
,"",_1071,1,1,1,0,1
,"",_1072,1,1,1,0,1
,"",_1073,1,1,1,0,1
,"",_1074,1,1,1,0,1
,"",_1075,1,1,0,0,0
,"",_1076,1,1,1,0,1
,"",_1077,1,1,1,0,1
,"",_1079,1,1,1,0,1
,"",_1080,1,1,1,0,1
,"",_1081,1,1,1,0,1
,"",_1082,1,1,1,0,1
,"",_1083,1,1,1,0,1
,"",_1084,1,1,1,0,1
,"",_1085,1,1,1,0,1
,"",_1086,1,1,1,0,1
,"",_1087,1,1,0,0,0
,"",_1088,1,1,1,0,1
,"",_1089,1,1,0,0,0
,"",_1090,1,1,1,0,1
,"",_1091,1,1,1,0,1
,"",_1092,1,1,0,0,0
,"",_1093,1,1,1,0,1
,"",_1094,1,1,0,0,0
,"",_1095,1,1,0,0,0
,"",_1098,1,1,1,0,1
,"",_1099,1,1,1,0,1
,"",_1100,1,1,1,0,1
,"",_1101,1,1,1,0,1
,"",_1102,1,1,1,0,1
,"",_1103,1,1,1,0,1
,"",_1104,1,1,1,0,1
,"",_1105,1,1,1,0,1
,"",_1106,1,1,1,0,1
,"",_1107,1,1,1,0,1
,"",_1108,1,1,1,0,1
,"",_1109,1,1,0,1,1
,"",_1110,1,1,1,0,1
,"",_1111,1,1,1,0,1
,"",_1112,1,1,1,0,1
,"",_1113,1,1,1,0,1
,"",_1114,1,1,1,0,1
,"",_1115,1,1,1,0,1
,"",_1116,1,1,1,0,1
,"",_1117,1,1,1,0,1
,"",_1118,1,1,0,0,0
,"",_1119,1,1,1,0,1
,"",_1121,1,1,1,0,1
,"",_1122,1,1,1,0,1
,"",_1123,1,1,1,0,1
,"",_1124,1,1,1,0,1
,"",_1125,1,1,1,0,1
,"",_1126,1,1,1,0,1
,"",_1127,1,1,1,0,1
,"",_1128,1,1,1,0,1
,"",_1129,1,1,1,0,1
,"",_1130,1,1,1,0,1
,"",_1132,1,1,1,0,1
,"",_1133,1,1,1,0,1
,"",_1134,1,1,1,0,1
,"",_1135,1,1,1,0,1
,"",_1136,1,1,1,0,1
,"",_1137,1,1,1,0,1
,"",_1139,1,1,1,0,1
,"",_1140,1,1,1,0,1
,"",_1141,1,1,1,0,1
,"",_1142,1,1,1,0,1
,"",_1143,1,1,1,0,1
,"",_1145,1,1,1,0,1
,"",_1146,1,1,1,0,1
,"",_1147,1,1,1,0,1
,"",_1148,1,1,1,0,1
,"",_1149,1,1,1,0,1
,"",_1150,1,1,1,0,1
,"",_1151,1,1,1,0,1
,"",_1153,1,1,1,0,1
,"",_1154,1,1,1,0,1
,"",_1156,1,1,1,0,1
,"",_1158,1,1,1,0,1
,"",_1159,1,1,1,0,1
,"",_1160,1,1,1,0,1
,"",_1161,1,1,1,0,1
,"",_1162,1,1,1,0,1
,"",_1163,1,1,1,0,1
,"",_1164,1,1,0,0,0
,"",_1165,1,1,1,0,1
,"",_1166,1,1,1,0,1
,"",_1168,1,1,1,0,1
,"",_1169,1,1,1,0,1
,"",_1171,1,1,1,0,1
,"",_1173,1,1,1,0,1
,"",_1174,1,1,0,0,0
,"",_1176,1,1,1,0,1
,"",_1177,1,1,1,0,1
,"",_1178,1,1,1,0,1
,"",_1180,1,1,1,0,1
,"",_1181,1,1,1,0,1
,"",_1183,1,1,1,0,1
,"",_1184,1,1,1,0,1
,"",_1185,1,1,1,0,1
,"",_1186,1,1,1,0,1
,"",_1187,1,1,1,0,1
,"",_1188,1,1,1,0,1
,"",_1189,1,1,1,0,1
,"",_1190,1,1,1,0,1
,"",_1191,1,1,0,0,0
,"",_1193,1,1,1,0,1
,"",_1194,1,1,0,1,1
,"",_1195,1,1,1,0,1
,"",_1196,1,1,1,0,1
,"",_1197,1,1,1,0,1
,"",_1199,1,1,1,0,1
,"",_1200,1,1,1,0,1
,"",_1201,1,1,1,0,1
,"",_1202,1,1,1,0,1
,"",_1203,1,1,1,0,1
,"",_1204,1,1,1,0,1
,"",_1205,1,1,1,0,1
,"",_1206,1,1,1,0,1
,"",_1207,1,1,1,0,1
,"",_1210,1,1,1,0,1
,"",_1211,1,1,1,0,1
,"",_1212,1,1,1,0,1
,"",_1213,1,1,1,0,1
,"",_1215,1,1,1,0,1
,"",_1216,1,1,1,0,1
,"",_1217,1,1,1,0,1
,"",_1218,1,1,1,0,1
,"",_1219,1,1,1,0,1
,"",_1221,1,1,1,0,1
,"",_1222,1,1,1,0,1
,"",_1223,1,1,1,0,1
,"",_1224,1,1,1,0,1
,"",_1225,1,1,1,0,1
,"",_1226,1,1,1,0,1
,"",_1227,1,1,1,0,1
,"",_1228,1,1,1,0,1
,"",_1229,1,1,1,0,1
,"",_1230,1,1,1,0,1
,"",_1232,1,1,1,0,1
,"",_1233,1,1,1,0,1
,"",_1235,1,1,1,0,1
,"",_1236,1,1,1,0,1
,"",_1237,1,1,1,0,1
,"",_1238,1,1,1,0,1
,"",_1239,1,1,1,0,1
,"",_1241,1,1,1,0,1
,"",_1243,1,1,1,0,1
,"",_1244,1,1,1,0,1
,"",_1246,1,1,1,0,1
,"",_1247,1,1,1,0,1
,"",_1249,1,1,1,0,1
,"",_1251,1,1,1,0,1
,"",_1252,1,1,1,0,1
,"",_1254,1,1,1,0,1
,"",_1255,1,1,1,0,1
,"",_1256,1,1,1,0,1
,"",_1257,1,1,0,1,1
,"",_1258,1,1,1,0,1
,"",_1259,1,1,1,0,1
,"",_1260,1,1,1,0,1
,"",_1261,1,1,1,0,1
,"",_1262,1,1,1,0,1
,"",_1263,1,1,1,0,1
,"",_1264,1,1,1,0,1
,"",_1266,1,1,0,0,0
,"",_1267,1,1,1,0,1
,"",_1269,1,1,1,0,1
,"",_1270,1,1,0,0,0
,"",_1271,1,1,1,0,1
,"",_1272,1,1,1,0,1
,"",_1275,1,1,1,0,1
,"",_1276,1,1,0,1,1
,"",_1277,1,1,1,0,1
,"",_1278,1,1,1,0,1
,"",_1279,1,1,1,0,1
,"",_1280,1,1,1,0,1
,"",_1281,1,1,1,0,1
,"",_1282,1,1,1,0,1
,"",_1283,1,1,1,0,1
,"",_1284,1,1,1,0,1
,"",_1285,1,1,1,0,1
,"",_1286,1,1,1,0,1
,"",_1287,1,1,1,0,1
,"",_1288,1,1,1,0,1
,"",_1290,1,1,1,0,1
,"",_1291,1,1,1,0,1
,"",_1292,1,1,0,0,0
,"",_1293,1,1,1,0,1
,"",_1294,1,1,1,0,1
,"",_1295,1,1,1,0,1
,"",_1298,1,1,1,0,1
,"",_1299,1,1,1,0,1
,"",_1300,1,1,1,0,1
,"",_1302,1,1,1,0,1
,"",_1303,1,1,1,0,1
,"",_1305,1,1,1,0,1
,"",_1306,1,1,1,0,1
,"",_1308,1,1,1,0,1
,"",_1309,1,1,1,0,1
,"",_1310,1,1,1,0,1
,"",_1311,1,1,1,0,1
,"",_1312,1,1,1,0,1
,"",_1313,1,1,1,0,1
,"",_1314,1,1,1,0,1
,"",_1315,1,1,1,0,1
,"",_1316,1,1,1,0,1
,"",_1317,1,1,1,0,1
,"",_1318,1,1,1,0,1
,"",_1319,1,1,1,0,1
,"",_1320,1,1,1,0,1
,"",_1321,1,1,1,0,1
,"",_1322,1,1,1,0,1
,"",_1323,1,1,1,0,1
,"",_1324,1,1,1,0,1
,"",_1325,1,1,1,0,1
,"",_1326,1,1,1,0,1
,"",_1327,1,1,1,0,1
,"",_1329,1,1,1,0,1
,"",_1330,1,1,1,0,1
,"",_1331,1,1,1,0,1
,"",_1334,1,1,1,0,1
,"",_1336,1,1,1,0,1
,"",_1337,1,1,1,0,1
,"",_1338,1,1,1,0,1
,"",_1339,1,1,1,0,1
,"",_1340,1,1,1,0,1
,"",_1341,1,1,1,0,1
,"",_1342,1,1,1,0,1
,"",_1343,1,1,1,0,1
,"",_1344,1,1,1,0,1
,"",_1345,1,1,1,0,1
,"",_1346,1,1,1,0,1
,"",_1347,1,1,1,0,1
,"",_1348,1,1,1,0,1
,"",_1349,1,1,1,0,1
,"",_1350,1,1,1,0,1
,"",_1353,1,1,0,1,1
,"",_1354,1,1,1,0,1
,"",_1355,1,1,1,0,1
,"",_1356,1,1,1,0,1
,"",_1357,1,1,1,0,1
,"",_1358,1,1,0,0,0
,"",_1361,1,1,1,0,1
,"",_1362,1,1,1,0,1
,"",_1363,1,1,1,0,1
,"",_1364,1,1,1,0,1
,"",_1365,1,1,1,0,1
,"",_1366,1,1,1,0,1
,"",_1367,1,1,1,0,1
,"",_1368,1,1,1,0,1
,"",_1369,1,1,1,0,1
,"",_1370,1,1,1,0,1
,"",_1371,1,1,1,0,1
,"",_1372,1,1,1,0,1
,"",_1373,1,1,1,0,1
,"",_1374,1,1,1,0,1
,"",_1375,1,1,1,0,1
,"",_1376,1,1,1,0,1
,"",_1378,1,1,1,0,1
,"",_1379,1,1,1,0,1
,"",_1380,1,1,1,0,1
,"",_1381,1,1,1,0,1
,"",_1382,1,1,1,0,1
,"",_1383,1,1,1,0,1
,"",_1384,1,1,1,0,1
,"",_1385,1,1,1,0,1
,"",_1386,1,1,1,0,1
,"",_1387,1,1,1,0,1
,"",_1388,1,1,1,0,1
,"",_1390,1,1,1,0,1
,"",_1391,1,1,1,0,1
,"",_1392,1,1,1,0,1
,"",_1393,1,1,1,0,1
,"",_1394,1,1,1,0,1
,"",_1396,1,1,1,0,1
,"",_1399,1,1,1,0,1
,"",_1400,1,1,1,0,1
,"",_1401,1,1,1,0,1
,"",_1403,1,1,1,0,1
,"",_1404,1,1,1,0,1
,"",_1405,1,1,0,0,0
,"",_1407,1,1,1,0,1
,"",_1408,1,1,1,0,1
,"",_1409,1,1,1,0,1
,"",_1410,1,1,1,0,1
,"",_1411,1,1,1,0,1
,"",_1412,1,1,1,0,1
,"",_1413,1,1,1,0,1
,"",_1414,1,1,1,0,1
,"",_1415,1,1,1,0,1
,"",_1416,1,1,1,0,1
,"",_1417,1,1,1,0,1
,"",_1419,1,1,1,0,1
,"",_1420,1,1,1,0,1
,"",_1421,1,1,1,0,1
,"",_1422,1,1,1,0,1
,"",_1423,1,1,1,0,1
,"",_1424,1,1,1,0,1
,"",_1425,1,1,1,0,1
,"",_1427,1,1,1,0,1
,"",_1428,1,1,1,0,1
,"",_1429,1,1,1,0,1
,"",_1430,1,1,1,0,1
,"",_1431,1,1,1,0,1
,"",_1434,1,1,1,0,1
,"",_1435,1,1,1,0,1
,"",_1436,1,1,1,0,1
,"",_1437,1,1,1,0,1
,"",_1438,1,1,1,0,1
,"",_1439,1,1,1,0,1
,"",_1440,1,1,1,0,1
,"",_1441,1,1,1,0,1
,"",_1443,1,1,1,0,1
,"",_1444,1,1,0,0,0
,"",_1445,1,1,1,0,1
,"",_1446,1,1,1,0,1
,"",_1447,1,1,1,0,1
,"",_1448,1,1,1,0,1
,"",_1450,1,1,1,0,1
,"",_1451,1,1,1,0,1
,"",_1452,1,1,1,0,1
,"",_1454,1,1,1,0,1
,"",_1455,1,1,1,0,1
,"",_1456,1,1,1,0,1
,"",_1457,1,1,1,0,1
,"",_1458,1,1,1,0,1
,"",_1459,1,1,1,0,1
,"",_1460,1,1,1,0,1
,"",_1461,1,1,1,0,1
,"",_1462,1,1,1,0,1
,"",_1463,1,1,1,0,1
,"",_1465,1,1,1,0,1
,"",_1466,1,1,1,0,1
,"",_1467,1,1,1,0,1
,"",_1468,1,1,1,0,1
,"",_1469,1,1,1,0,1
,"",_1470,1,1,1,0,1
,"",_1471,1,1,1,0,1
,"",_1472,1,1,1,0,1
,"",_1473,1,1,0,0,0
,"",_1474,1,1,1,0,1
,"",_1475,1,1,1,0,1
,"",_1476,1,1,1,0,1
,"",_1477,1,1,1,0,1
,"",_1478,1,1,1,0,1
,"",_1479,1,1,1,0,1
,"",_1480,1,1,1,0,1
,"",_1481,1,1,1,0,1
,"",_1482,1,1,1,0,1
,"",_1483,1,1,1,0,1
,"",_1484,1,1,1,0,1
,"",_1486,1,1,1,0,1
,"",_1487,1,1,1,0,1
,"",_1488,1,1,1,0,1
,"",_1489,1,1,1,0,1
,"",_1490,1,1,1,0,1
,"",_1491,1,1,1,0,1
,"",_1492,1,1,1,0,1
,"",_1493,1,1,1,0,1
,"",_1494,1,1,1,0,1
,"",_1496,1,1,1,0,1
,"",_1497,1,1,1,0,1
,"",_1498,1,1,1,0,1
,"",_1500,1,1,1,0,1
,"",_1501,1,1,1,0,1
,"",_1502,1,1,1,0,1
,"",_1503,1,1,1,0,1
,"",_1504,1,1,1,0,1
,"",_1505,1,1,1,0,1
,"",_1506,1,1,1,0,1
,"",_1507,1,1,1,0,1
,"",_1508,1,1,1,0,1
,"",_1509,1,1,1,0,1
,"",_1510,1,1,1,0,1
,"",_1511,1,1,1,0,1
,"",_1512,1,1,1,0,1
,"",_1513,1,1,1,0,1
,"",_1514,1,1,1,0,1
,"",_1515,1,1,1,0,1
,"",_1516,1,1,1,0,1
,"",_1517,1,1,1,0,1
,"",_1518,1,1,1,0,1
,"",_1519,1,1,1,0,1
,"",_1520,1,1,1,0,1
,"",_1521,1,1,1,0,1
,"",_1522,1,1,1,0,1
,"",_1523,1,1,0,1,1
,"",_1524,1,1,1,0,1
,"",_1525,1,1,1,0,1
,"",_1526,1,1,1,0,1
,"",_1527,1,1,1,0,1
,"",_1528,1,1,1,0,1
,"",_1529,1,1,0,0,0
,"",_1530,1,1,1,0,1
,"",_1531,1,1,1,0,1
,"",_1533,1,1,1,0,1
,"",_1534,1,1,1,0,1
,"",_1535,1,1,1,0,1
,"",_1536,1,1,1,0,1
,"",_1538,1,1,1,0,1
,"",_1541,1,1,1,0,1
,"",_1542,1,1,1,0,1
,"",_1543,1,1,1,0,1
,"",_1544,1,1,1,0,1
,"",_1546,1,1,1,0,1
,"",_1547,1,1,1,0,1
,"",_1548,1,1,1,0,1
,"",_1549,1,1,1,0,1
,"",_1550,1,1,1,0,1
,"",_1551,1,1,1,0,1
,"",_1552,1,1,1,0,1
,"",_1553,1,1,1,0,1
,"",_1554,1,1,1,0,1
,"",_1555,1,1,0,1,1
,"",_1556,1,1,1,0,1
,"",_1557,1,1,1,0,1
,"",_1558,1,1,1,0,1
,"",_1559,1,1,1,0,1
,"",_1560,1,1,1,0,1
,"",_1561,1,1,0,0,0
,"",_1562,1,1,1,0,1
,"",_1563,1,1,1,0,1
,"",_1564,1,1,0,0,0
,"",_1565,1,1,1,0,1
,"",_1566,1,1,1,0,1
,"",_1567,1,1,1,0,1
,"",_1568,1,1,1,0,1
,"",_1569,1,1,1,0,1
,"",_1570,1,1,1,0,1
,"",_1571,1,1,1,0,1
,"",_1572,1,1,1,0,1
,"",_1573,1,1,1,0,1
,"",_1574,1,1,1,0,1
,"",_1575,1,1,1,0,1
,"",_1577,1,1,1,0,1
,"",_1578,1,1,1,0,1
,"",_1579,1,1,1,0,1
,"",_1580,1,1,1,0,1
,"",_1582,1,1,1,0,1
,"",_1583,1,1,1,0,1
,"",_1584,1,1,1,0,1
,"",_1585,1,1,1,0,1
,"",_1586,1,1,1,0,1
,"",_1587,1,1,0,0,0
,"",_1589,1,1,1,0,1
,"",_1590,1,1,1,0,1
,"",_1591,1,1,1,0,1
,"",_1592,1,1,1,0,1
,"",_1593,1,1,1,0,1
,"",_1594,1,1,1,0,1
,"",_1595,1,1,1,0,1
,"",_1596,1,1,1,0,1
,"",_1597,1,1,1,0,1
,"",_1598,1,1,1,0,1
,"",_1599,1,1,1,0,1
,"",_1600,1,1,1,0,1
,"",_1601,1,1,1,0,1
,"",_1602,1,1,1,0,1
,"",_1604,1,1,1,0,1
,"",_1605,1,1,1,0,1
,"",_1607,1,1,1,0,1
,"",_1608,1,1,1,0,1
,"",_1609,1,1,0,1,1
,"",_1611,1,1,1,0,1
,"",_1612,1,1,1,0,1
,"",_1613,1,1,1,0,1
,"",_1615,1,1,1,0,1
,"",_1616,1,1,1,0,1
,"",_1618,1,1,1,0,1
,"",_1619,1,1,1,0,1
,"",_1620,1,1,0,0,0
,"",_1621,1,1,1,0,1
,"",_1622,1,1,1,0,1
,"",_1625,1,1,1,0,1
,"",_1626,1,1,1,0,1
,"",_1627,1,1,1,0,1
,"",_1628,1,1,1,0,1
,"",_1629,1,1,1,0,1
,"",_1631,1,1,1,0,1
,"",_1632,1,1,1,0,1
,"",_1633,1,1,1,0,1
,"",_1634,1,1,1,0,1
,"",_1636,1,1,1,0,1
,"",_1637,1,1,1,0,1
,"",_1638,1,1,1,0,1
,"",_1639,1,1,1,0,1
,"",_1640,1,1,1,0,1
,"",_1641,1,1,1,0,1
,"",_1642,1,1,1,0,1

