Name,Description,Combined Group,Unique Machines,Unique UserID, Count F,Count H,EULA Machines
NTU,"",_4,122,94,119,3,122
,"",_1,102,99,85,11,96
,"",_2,82,78,35,42,77
NYP,"",_21,47,40,43,1,44
,"",_5,37,32,27,2,29
,"",_6,35,35,20,1,21
,"",_9,33,28,17,6,23
,"",_7,31,30,20,5,25
,"",_12,29,30,19,1,20
Unity,"",_3,27,25,12,2,14
Mages,"",_25,27,24,24,0,24
,"",_13,27,26,14,4,18
,"",_15,27,24,17,3,20
Vincent Goh,"",_22,21,15,21,0,21
,"",_8,21,18,9,3,12
,"",_16,21,23,17,2,19
Gumi,"",_23,17,17,1,0,1
,"",_11,16,17,10,2,12
,"",_17,16,15,7,2,9
,"",_18,16,16,9,0,9
NUS,"",_64,15,11,11,0,11
,"",_10,15,14,6,3,9
,"",_14,15,15,7,1,8
Koei Tecmo,"",_28,14,14,2,0,2
Tendays Studio / Ignite VR,"",_35,12,9,8,0,8
Singapore Poly / Chesterfield,"http://chesterfield.sg/
Singapore Polytechnic
",_108,12,7,11,0,11
Singapore Poly,"",_44,12,7,12,0,12
IGG,"",_40,12,12,1,0,1
89trillion.com,"",_27,12,12,11,0,11
,"",_30,12,11,10,2,12
SUTD,"",_41,11,9,10,0,10
,"",_19,11,13,7,2,9
,"",_37,11,10,9,0,9
Aviation Virtual,"",_50,10,8,9,0,9
SIT,"",_71,9,8,9,0,9
,"",_20,9,11,5,1,6
,"",_38,9,9,9,0,9
,"",_39,9,8,8,0,8
White Label Studio,"https://whitelabelstudio.global/
",_87,8,4,5,0,5
Temasek Poly,"",_82,7,7,3,1,4
Autumn Interactive,"",_58,7,5,5,0,5
,"",_33,7,6,5,1,6
The Carrot Studio,"",_84,6,5,5,0,5
Swagsoft,"",_46,6,4,2,0,2
Mighty Bear,"",_161,6,6,1,0,1
Hiverlab,"https://www.hiverlab.com/
",_42,6,4,3,0,3
,"",_36,6,6,6,0,6
,"",_53,6,5,3,1,4
,"",_55,6,6,2,4,6
,"",_61,6,6,6,0,6
,"",_62,6,6,6,0,6
Yoozoo games,"https://global.yoozoo.com/news/7000056.html
",_207,5,5,5,0,5
EON Reality,"",_110,5,4,0,0,0
DSO HEDP,"",_103,5,3,5,0,5
,"",_49,5,4,4,0,4
,"ST Engineering
",_70,5,3,4,0,4
,"",_72,5,5,3,0,3
Revez Digital,"http://revezdigital.com/
Plus license
",_54,4,4,4,0,4
NUS Engineering Design and Innovation Centre,"",_149,4,3,2,0,2
Land Shark Games,"",_152,4,4,0,0,0
Korea user,"",_85,4,3,3,0,3
GovTech,"rayjue99@hotmail.com
hazel77744@gmail.com
",_390,4,4,2,0,2
Exousia Studios,"",_237,4,3,4,0,4
Electricsquare,"",_99,4,4,0,0,0
Chariots Gaming,"",_153,4,3,0,0,0
Aviationlearn.com,"",_57,4,3,3,0,3
,"",_48,4,3,4,0,4
,"",_65,4,3,4,0,4
,"",_77,4,4,3,1,4
,"",_94,4,3,3,0,3
,"",_98,4,4,4,0,4
,"",_119,4,3,3,0,3
VR Collab,"",_106,3,3,0,0,0
Trinax,"",_34,3,2,0,0,0
Silversea Media,"https://www.silversea-media.com/
",_285,3,2,0,3,3
SideFX Studios,"https://genesis.hq.unity3d.com/organizations/1374436136701/
",_51,3,4,0,0,0
Royce Media,"",_52,3,2,3,0,3
PlayTech Studio,"",_369,3,1,3,0,3
New Future Games,"",_252,3,3,3,0,3
Marina Bay Sands,"sinonet3d@gmail.com
https://genesis.hq.unity3d.com/organizations/18966836212561/
millernguyen.mbs@gmail.com
liulink@gmail.com
",_175,3,2,3,0,3
https://www.xiibraves.com/,"Org with 11 members
",_121,3,3,1,0,1
Anacle,"",_312,3,3,0,0,0
,"",_56,3,1,3,0,3
,"",_95,3,3,3,0,3
,"",_97,3,3,3,0,3
,"",_101,3,2,3,0,3
,"",_102,3,3,1,0,1
,"",_104,3,3,1,2,3
,"",_105,3,2,3,0,3
,"",_123,3,2,3,0,3
,"",_132,3,3,3,0,3
,"",_143,3,3,3,0,3
,"",_150,3,1,3,0,3
,"",_151,3,3,2,1,3
,"",_162,3,3,3,0,3
,"",_167,3,3,3,0,3
,"",_176,3,3,3,0,3
,"",_178,3,3,3,0,3
,"",_179,3,3,2,0,2
,"",_191,3,2,3,0,3
,"",_234,3,1,1,0,1
,"",_291,3,1,3,0,3
Vividthree,"",_318,2,2,0,0,0
The iterative Collective,"https://theiterative.co/
",_182,2,2,2,0,2
Taggle Health,"",_492,2,1,1,0,1
STE Training & Simulation,"leong.guowei@stengg.com	
liew.wanhui@stee.stengg.com
kohwuisiong2@gmail.com
",_76,2,2,1,0,1
StarSprite,"http://starsprite.com/
",_226,2,2,1,0,1
ST Engineering Land Systems,"",_256,2,1,1,0,1
Siemens - Lim Riqui,"https://genesis.hq.unity3d.com/users/18966804306463/
",_254,2,1,2,0,2
NTU VR Lab,"",_290,2,1,2,0,2
Meshtint,"",_1095,2,1,2,0,2
Mersiva LLP / Iceberg Design,"",_154,2,2,2,0,2
Make Studios,"",_428,2,1,2,0,2
DSTA,"https://genesis.hq.unity3d.com/users/5336777/
",_173,2,3,2,0,2
Cybervision,"",_183,2,2,2,0,2
Bui_Thanh (VN),"",_287,2,2,0,2,2
Azurite,"",_247,2,2,1,0,1
A-Star,"https://genesis.hq.unity3d.com/organizations/18966615602330/
",_723,2,3,0,0,0
AAT Training Hub,"",_186,2,1,0,0,0
,"",_24,2,2,2,0,2
,"",_66,2,2,1,1,2
,"",_67,2,2,2,0,2
,"",_68,2,2,2,0,2
,"",_75,2,2,1,1,2
,"",_83,2,2,2,0,2
,"",_89,2,1,2,0,2
,"",_96,2,2,2,0,2
,"",_115,2,1,2,0,2
,"",_124,2,2,2,0,2
,"",_131,2,2,2,0,2
,"",_134,2,1,2,0,2
,"",_135,2,2,2,0,2
,"",_137,2,2,2,0,2
,"",_138,2,2,1,0,1
,"",_140,2,2,2,0,2
,"",_142,2,2,2,0,2
,"",_148,2,1,2,0,2
,"",_157,2,1,2,0,2
,"",_158,2,1,2,0,2
,"",_159,2,3,2,0,2
,"",_160,2,2,2,0,2
,"",_170,2,1,2,0,2
,"",_171,2,1,2,0,2
,"",_185,2,1,2,0,2
,"",_189,2,2,2,0,2
,"",_192,2,2,2,0,2
,"",_193,2,2,2,0,2
,"",_198,2,2,2,0,2
,"",_199,2,2,2,0,2
,"",_201,2,2,2,0,2
,"",_202,2,2,2,0,2
,"",_203,2,1,2,0,2
,"",_205,2,1,2,0,2
,"",_206,2,1,2,0,2
,"",_209,2,1,2,0,2
,"",_217,2,2,2,0,2
,"",_218,2,2,2,0,2
,"",_227,2,2,2,0,2
,"",_231,2,1,2,0,2
,"",_248,2,2,2,0,2
,"",_249,2,2,1,1,2
,"",_250,2,2,1,0,1
,"",_253,2,2,2,0,2
,"",_255,2,2,2,0,2
,"",_257,2,1,2,0,2
,"",_258,2,1,2,0,2
,"",_262,2,2,0,0,0
,"",_264,2,2,2,0,2
,"",_265,2,2,1,0,1
,"",_266,2,2,2,0,2
,"",_282,2,2,2,0,2
,"",_286,2,1,2,0,2
,"",_289,2,1,2,0,2
,"",_301,2,2,2,0,2
,"",_302,2,2,2,0,2
,"",_304,2,2,2,0,2
,"",_309,2,2,2,0,2
,"",_310,2,1,2,0,2
,"",_315,2,1,2,0,2
,"",_329,2,1,2,0,2
,"",_330,2,1,2,0,2
,"",_331,2,2,1,0,1
,"",_341,2,2,2,0,2
,"",_343,2,2,2,0,2
,"",_347,2,1,1,0,1
,"",_348,2,2,2,0,2
,"",_350,2,1,1,0,1
,"",_355,2,1,2,0,2
,"",_358,2,1,2,0,2
,"",_363,2,2,2,0,2
,"",_364,2,1,2,0,2
,"",_367,2,2,2,0,2
,"",_372,2,1,2,0,2
,"",_382,2,1,2,0,2
,"",_389,2,1,2,0,2
,"",_394,2,2,2,0,2
,"",_403,2,2,2,0,2
,"",_409,2,2,2,0,2
,"",_533,2,1,2,0,2
,"",_633,2,1,2,0,2
,"",_669,2,1,2,0,2
,"",_879,2,1,2,0,2
,"",_904,2,1,2,0,2
,"",_934,2,1,2,0,2
,"",_975,2,1,2,0,2
,"",_1061,2,1,2,0,2
,"",_1066,2,1,2,0,2
Visenze,"",_448,1,1,1,0,1
Ubisoft,"https://genesis.hq.unity3d.com/users/20066241185396/
",_639,1,1,0,0,0
Terresqual,"",_129,1,1,1,0,1
Starstruck Games,"",_647,1,1,1,0,1
Singapore American School,"",_1184,1,1,1,0,1
Shadowbyte Games,"",_1006,1,1,0,0,0
Quantum Jump Tech,"http://qjdev.lihailouti.cn/%E5%85%B3%E4%BA%8E%E7%90%A6%E6%99%AF%E7%A7%91%E6%8A%80
https://genesis.hq.unity3d.com/organizations/18966610847599/members-groups
",_811,1,1,1,0,1
Presence Pictures VR,"https://app.presencepictures.com.sg/storePages/presenceImages/PresencePicturesAboutUs.pdf#toolbar=0&navpanes=0&scrollbar=0
",_742,1,1,0,0,0
Pern Jie,"",_622,1,1,1,0,1
Orca Studios,"",_658,1,1,0,0,0
NUS-HCI Lab,"",_306,1,1,1,0,1
iShorty,"",_379,1,1,1,0,1
Hennery Studio,"",_996,1,1,1,0,1
Brandon Gui,"",_111,1,1,0,0,0
Bandai Namco,"",_544,1,1,0,0,0
Appigniter,"https://www.appigniter.co/
Plus license
",_346,1,1,0,0,0
,"",_47,1,1,1,0,1
,"",_60,1,1,1,0,1
,"",_63,1,1,1,0,1
,"",_69,1,1,1,0,1
,"",_73,1,1,1,0,1
,"",_74,1,1,1,0,1
,"",_78,1,1,1,0,1
,"",_79,1,1,1,0,1
,"",_80,1,1,1,0,1
,"",_86,1,1,1,0,1
,"",_88,1,1,1,0,1
,"",_90,1,1,1,0,1
,"",_91,1,1,1,0,1
,"",_93,1,1,1,0,1
,"",_112,1,1,1,0,1
,"",_116,1,1,1,0,1
,"",_117,1,1,0,1,1
,"",_120,1,1,1,0,1
,"",_122,1,1,1,0,1
,"",_125,1,2,0,0,0
,"",_127,1,1,1,0,1
,"",_128,1,1,0,1,1
,"",_133,1,1,1,0,1
,"",_136,1,1,1,0,1
,"",_139,1,1,1,0,1
,"",_141,1,1,1,0,1
,"",_144,1,1,1,0,1
,"",_145,1,1,1,0,1
,"",_146,1,1,0,0,0
,"",_147,1,1,1,0,1
,"",_155,1,1,1,0,1
,"",_156,1,2,1,0,1
,"",_163,1,1,0,1,1
,"",_164,1,1,0,0,0
,"",_165,1,1,0,0,0
,"",_168,1,1,1,0,1
,"",_169,1,1,0,0,0
,"",_172,1,2,1,0,1
,"",_174,1,1,1,0,1
,"",_177,1,1,1,0,1
,"",_180,1,1,1,0,1
,"",_181,1,1,0,1,1
,"",_184,1,1,1,0,1
,"",_187,1,1,1,0,1
,"",_188,1,1,1,0,1
,"",_190,1,1,1,0,1
,"",_194,1,1,1,0,1
,"",_195,1,1,1,0,1
,"",_196,1,1,1,0,1
,"",_197,1,1,1,0,1
,"",_200,1,1,1,0,1
,"",_204,1,1,1,0,1
,"",_208,1,1,1,0,1
,"",_210,1,1,1,0,1
,"",_212,1,1,1,0,1
,"",_213,1,1,1,0,1
,"",_214,1,1,1,0,1
,"",_215,1,1,1,0,1
,"",_216,1,1,1,0,1
,"",_219,1,1,1,0,1
,"",_220,1,1,0,0,0
,"",_221,1,1,1,0,1
,"",_222,1,1,1,0,1
,"",_223,1,2,1,0,1
,"",_224,1,1,1,0,1
,"",_229,1,1,1,0,1
,"",_230,1,1,1,0,1
,"",_232,1,2,0,1,1
,"",_233,1,1,1,0,1
,"",_235,1,1,1,0,1
,"",_236,1,1,1,0,1
,"",_238,1,1,1,0,1
,"",_239,1,1,1,0,1
,"",_240,1,1,1,0,1
,"",_241,1,1,1,0,1
,"",_243,1,1,1,0,1
,"",_245,1,1,1,0,1
,"",_246,1,1,1,0,1
,"",_251,1,1,1,0,1
,"",_259,1,1,1,0,1
,"",_260,1,1,1,0,1
,"",_261,1,1,1,0,1
,"",_263,1,1,1,0,1
,"",_267,1,1,1,0,1
,"",_268,1,1,1,0,1
,"",_269,1,1,1,0,1
,"",_270,1,1,1,0,1
,"",_271,1,1,1,0,1
,"",_272,1,1,1,0,1
,"",_274,1,2,1,0,1
,"",_275,1,2,1,0,1
,"",_276,1,1,1,0,1
,"",_277,1,1,0,0,0
,"",_278,1,1,1,0,1
,"",_279,1,1,1,0,1
,"",_280,1,1,1,0,1
,"",_281,1,1,1,0,1
,"",_283,1,1,0,0,0
,"",_284,1,1,0,0,0
,"",_288,1,1,1,0,1
,"",_293,1,1,1,0,1
,"",_294,1,1,1,0,1
,"",_295,1,1,1,0,1
,"",_296,1,1,1,0,1
,"",_297,1,1,0,0,0
,"",_298,1,1,1,0,1
,"",_299,1,1,1,0,1
,"",_303,1,1,1,0,1
,"",_305,1,1,1,0,1
,"",_307,1,1,1,0,1
,"",_308,1,1,0,0,0
,"",_311,1,1,1,0,1
,"",_313,1,1,0,0,0
,"",_314,1,1,1,0,1
,"",_316,1,1,1,0,1
,"",_317,1,1,0,0,0
,"",_319,1,1,1,0,1
,"",_321,1,1,1,0,1
,"",_322,1,1,1,0,1
,"",_323,1,1,1,0,1
,"",_324,1,1,1,0,1
,"",_325,1,1,1,0,1
,"",_326,1,1,0,0,0
,"",_327,1,1,0,0,0
,"",_328,1,1,1,0,1
,"",_332,1,1,1,0,1
,"",_334,1,1,1,0,1
,"",_335,1,1,1,0,1
,"",_336,1,1,1,0,1
,"",_338,1,1,1,0,1
,"",_339,1,1,1,0,1
,"",_342,1,1,1,0,1
,"",_344,1,1,1,0,1
,"",_345,1,1,1,0,1
,"",_349,1,1,1,0,1
,"",_351,1,1,0,0,0
,"",_352,1,1,1,0,1
,"",_353,1,1,1,0,1
,"",_354,1,1,1,0,1
,"",_356,1,1,1,0,1
,"",_357,1,1,1,0,1
,"",_360,1,1,1,0,1
,"",_361,1,1,1,0,1
,"",_362,1,1,1,0,1
,"",_365,1,1,0,0,0
,"",_366,1,1,1,0,1
,"",_368,1,1,1,0,1
,"",_370,1,1,1,0,1
,"",_371,1,1,1,0,1
,"",_373,1,1,1,0,1
,"",_375,1,1,0,0,0
,"",_376,1,1,1,0,1
,"",_377,1,1,1,0,1
,"",_378,1,1,1,0,1
,"",_380,1,1,1,0,1
,"",_381,1,1,1,0,1
,"",_384,1,1,1,0,1
,"",_385,1,1,1,0,1
,"",_387,1,1,1,0,1
,"",_388,1,2,1,0,1
,"",_392,1,1,1,0,1
,"",_393,1,1,1,0,1
,"",_395,1,1,1,0,1
,"",_396,1,1,1,0,1
,"",_397,1,1,1,0,1
,"",_398,1,1,1,0,1
,"",_399,1,1,1,0,1
,"",_401,1,2,1,0,1
,"",_402,1,1,1,0,1
,"",_404,1,1,1,0,1
,"",_405,1,1,1,0,1
,"",_406,1,1,1,0,1
,"",_407,1,1,0,0,0
,"",_410,1,1,1,0,1
,"",_411,1,1,1,0,1
,"",_413,1,1,1,0,1
,"",_414,1,1,1,0,1
,"",_415,1,1,1,0,1
,"",_416,1,1,1,0,1
,"",_417,1,1,1,0,1
,"",_418,1,1,1,0,1
,"",_419,1,1,1,0,1
,"",_420,1,1,0,0,0
,"",_421,1,1,1,0,1
,"",_422,1,1,1,0,1
,"",_423,1,1,1,0,1
,"",_424,1,1,1,0,1
,"",_425,1,1,0,0,0
,"",_426,1,1,1,0,1
,"",_427,1,1,1,0,1
,"",_429,1,1,1,0,1
,"",_430,1,1,1,0,1
,"",_431,1,1,1,0,1
,"",_432,1,1,1,0,1
,"",_433,1,1,1,0,1
,"",_435,1,1,1,0,1
,"",_436,1,1,1,0,1
,"",_437,1,1,1,0,1
,"",_438,1,1,1,0,1
,"",_439,1,1,1,0,1
,"",_440,1,1,1,0,1
,"",_442,1,1,1,0,1
,"",_443,1,1,1,0,1
,"",_444,1,1,1,0,1
,"",_445,1,1,1,0,1
,"",_446,1,1,1,0,1
,"",_447,1,1,1,0,1
,"",_449,1,1,1,0,1
,"",_450,1,1,1,0,1
,"",_451,1,1,1,0,1
,"",_452,1,1,1,0,1
,"",_453,1,1,1,0,1
,"",_454,1,1,1,0,1
,"",_456,1,1,1,0,1
,"",_457,1,1,1,0,1
,"",_458,1,1,1,0,1
,"",_460,1,1,1,0,1
,"",_461,1,1,1,0,1
,"",_462,1,1,1,0,1
,"",_463,1,1,1,0,1
,"",_464,1,1,1,0,1
,"",_465,1,1,1,0,1
,"",_466,1,1,1,0,1
,"",_467,1,1,1,0,1
,"",_468,1,1,1,0,1
,"",_469,1,1,1,0,1
,"",_470,1,1,1,0,1
,"",_471,1,1,1,0,1
,"",_472,1,1,1,0,1
,"",_473,1,1,1,0,1
,"",_474,1,1,1,0,1
,"",_475,1,1,1,0,1
,"",_476,1,1,1,0,1
,"",_477,1,1,1,0,1
,"",_478,1,1,1,0,1
,"",_479,1,1,0,1,1
,"",_480,1,1,1,0,1
,"",_481,1,1,1,0,1
,"",_482,1,1,1,0,1
,"",_483,1,1,1,0,1
,"",_484,1,1,1,0,1
,"",_485,1,1,1,0,1
,"",_486,1,1,1,0,1
,"",_487,1,1,1,0,1
,"",_488,1,1,1,0,1
,"",_489,1,1,0,1,1
,"",_490,1,1,1,0,1
,"",_491,1,1,1,0,1
,"",_493,1,1,1,0,1
,"",_494,1,1,1,0,1
,"",_495,1,1,1,0,1
,"",_496,1,1,1,0,1
,"",_497,1,1,1,0,1
,"",_498,1,1,1,0,1
,"",_499,1,1,1,0,1
,"",_500,1,1,1,0,1
,"",_501,1,1,1,0,1
,"",_503,1,1,1,0,1
,"",_504,1,1,1,0,1
,"",_505,1,1,1,0,1
,"",_506,1,1,1,0,1
,"",_507,1,1,1,0,1
,"",_509,1,1,1,0,1
,"",_510,1,1,1,0,1
,"",_511,1,1,1,0,1
,"",_515,1,1,1,0,1
,"",_516,1,1,1,0,1
,"",_517,1,1,1,0,1
,"",_518,1,1,1,0,1
,"",_519,1,1,1,0,1
,"",_520,1,1,1,0,1
,"",_521,1,1,1,0,1
,"",_522,1,1,0,0,0
,"",_523,1,1,1,0,1
,"",_524,1,1,0,0,0
,"",_525,1,1,0,0,0
,"",_526,1,1,1,0,1
,"",_527,1,1,1,0,1
,"",_528,1,1,0,0,0
,"",_529,1,1,1,0,1
,"",_530,1,1,0,1,1
,"",_531,1,1,0,1,1
,"",_532,1,1,1,0,1
,"",_534,1,1,1,0,1
,"",_535,1,1,1,0,1
,"",_536,1,1,1,0,1
,"",_537,1,1,1,0,1
,"",_538,1,1,1,0,1
,"",_539,1,1,1,0,1
,"",_540,1,1,0,1,1
,"",_541,1,1,1,0,1
,"",_542,1,1,1,0,1
,"",_543,1,1,1,0,1
,"",_545,1,1,1,0,1
,"",_546,1,1,1,0,1
,"",_547,1,1,1,0,1
,"",_548,1,1,1,0,1
,"",_549,1,1,1,0,1
,"",_550,1,1,1,0,1
,"",_551,1,1,1,0,1
,"",_552,1,1,1,0,1
,"",_553,1,1,1,0,1
,"",_554,1,1,1,0,1
,"",_555,1,1,1,0,1
,"",_556,1,1,1,0,1
,"",_557,1,1,1,0,1
,"",_558,1,1,1,0,1
,"",_559,1,1,0,0,0
,"",_560,1,1,1,0,1
,"",_561,1,1,1,0,1
,"",_562,1,1,1,0,1
,"",_563,1,1,1,0,1
,"",_564,1,1,0,0,0
,"",_565,1,1,1,0,1
,"",_566,1,1,1,0,1
,"",_567,1,1,1,0,1
,"",_568,1,1,1,0,1
,"",_569,1,1,1,0,1
,"",_571,1,1,1,0,1
,"",_573,1,1,1,0,1
,"",_574,1,1,1,0,1
,"",_575,1,1,1,0,1
,"",_576,1,1,1,0,1
,"",_577,1,1,1,0,1
,"",_578,1,1,1,0,1
,"",_579,1,1,1,0,1
,"",_580,1,1,1,0,1
,"",_581,1,1,1,0,1
,"",_582,1,1,1,0,1
,"",_583,1,1,1,0,1
,"",_584,1,1,1,0,1
,"",_585,1,1,1,0,1
,"",_586,1,1,1,0,1
,"",_587,1,1,1,0,1
,"",_588,1,1,1,0,1
,"",_589,1,1,1,0,1
,"",_590,1,1,1,0,1
,"",_591,1,1,1,0,1
,"",_592,1,1,0,0,0
,"",_593,1,1,1,0,1
,"",_594,1,1,1,0,1
,"",_595,1,1,1,0,1
,"",_596,1,1,1,0,1
,"",_597,1,1,1,0,1
,"",_599,1,1,0,0,0
,"",_600,1,1,1,0,1
,"",_601,1,1,1,0,1
,"",_602,1,1,1,0,1
,"",_603,1,1,1,0,1
,"",_604,1,1,1,0,1
,"",_605,1,1,1,0,1
,"",_606,1,1,1,0,1
,"",_607,1,1,1,0,1
,"",_608,1,1,1,0,1
,"",_609,1,1,1,0,1
,"",_610,1,1,1,0,1
,"",_611,1,1,1,0,1
,"",_613,1,1,1,0,1
,"",_614,1,1,1,0,1
,"",_615,1,1,1,0,1
,"",_616,1,1,1,0,1
,"",_617,1,1,0,1,1
,"",_618,1,1,1,0,1
,"",_619,1,1,1,0,1
,"",_620,1,1,1,0,1
,"",_621,1,1,0,0,0
,"",_623,1,1,1,0,1
,"",_624,1,1,1,0,1
,"",_625,1,1,1,0,1
,"",_626,1,1,1,0,1
,"",_627,1,1,0,0,0
,"",_628,1,1,1,0,1
,"",_629,1,1,1,0,1
,"",_630,1,1,1,0,1
,"",_631,1,1,1,0,1
,"",_632,1,1,1,0,1
,"",_634,1,1,1,0,1
,"",_635,1,1,1,0,1
,"",_636,1,1,1,0,1
,"",_637,1,1,1,0,1
,"",_638,1,1,1,0,1
,"",_640,1,1,1,0,1
,"",_641,1,1,1,0,1
,"",_642,1,1,1,0,1
,"",_643,1,1,1,0,1
,"",_644,1,1,1,0,1
,"",_645,1,1,1,0,1
,"",_646,1,1,1,0,1
,"",_648,1,1,1,0,1
,"",_649,1,1,1,0,1
,"",_650,1,1,1,0,1
,"",_651,1,1,1,0,1
,"",_652,1,1,1,0,1
,"",_653,1,1,1,0,1
,"",_654,1,1,1,0,1
,"",_655,1,1,1,0,1
,"",_656,1,1,1,0,1
,"",_657,1,1,0,0,0
,"",_659,1,1,1,0,1
,"",_660,1,1,1,0,1
,"",_661,1,1,1,0,1
,"",_662,1,1,1,0,1
,"",_663,1,1,1,0,1
,"",_664,1,1,1,0,1
,"",_665,1,1,1,0,1
,"",_666,1,1,1,0,1
,"",_667,1,1,0,0,0
,"",_668,1,1,1,0,1
,"",_671,1,1,1,0,1
,"",_672,1,1,1,0,1
,"",_675,1,1,1,0,1
,"",_676,1,1,1,0,1
,"",_678,1,1,1,0,1
,"",_679,1,1,0,1,1
,"",_680,1,1,1,0,1
,"",_681,1,1,1,0,1
,"",_682,1,1,1,0,1
,"",_683,1,1,1,0,1
,"",_684,1,1,1,0,1
,"",_685,1,1,1,0,1
,"",_686,1,1,0,0,0
,"",_687,1,1,1,0,1
,"",_688,1,1,1,0,1
,"",_689,1,1,1,0,1
,"",_690,1,1,1,0,1
,"",_691,1,1,1,0,1
,"",_692,1,1,1,0,1
,"",_693,1,1,1,0,1
,"",_694,1,1,1,0,1
,"",_695,1,1,1,0,1
,"",_696,1,1,1,0,1
,"",_698,1,1,1,0,1
,"",_699,1,1,1,0,1
,"",_700,1,1,1,0,1
,"",_701,1,1,1,0,1
,"",_702,1,1,1,0,1
,"",_703,1,1,1,0,1
,"",_704,1,1,1,0,1
,"",_705,1,1,1,0,1
,"",_706,1,1,1,0,1
,"",_707,1,1,1,0,1
,"",_708,1,1,1,0,1
,"",_709,1,1,1,0,1
,"",_710,1,1,1,0,1
,"",_711,1,1,1,0,1
,"",_712,1,1,1,0,1
,"",_713,1,1,1,0,1
,"",_715,1,1,1,0,1
,"",_716,1,1,1,0,1
,"",_717,1,1,1,0,1
,"",_718,1,1,1,0,1
,"",_719,1,1,0,0,0
,"",_720,1,1,1,0,1
,"",_721,1,1,1,0,1
,"",_722,1,1,1,0,1
,"",_724,1,1,0,1,1
,"",_726,1,1,1,0,1
,"",_727,1,1,1,0,1
,"",_728,1,1,0,0,0
,"",_729,1,1,1,0,1
,"",_730,1,1,1,0,1
,"",_731,1,1,1,0,1
,"",_733,1,1,1,0,1
,"",_734,1,1,1,0,1
,"",_736,1,1,1,0,1
,"",_737,1,1,1,0,1
,"",_738,1,1,1,0,1
,"",_739,1,1,1,0,1
,"",_740,1,1,1,0,1
,"",_741,1,1,1,0,1
,"",_743,1,1,1,0,1
,"",_744,1,1,1,0,1
,"",_745,1,1,1,0,1
,"",_746,1,1,1,0,1
,"",_747,1,1,1,0,1
,"",_748,1,1,1,0,1
,"",_749,1,1,1,0,1
,"",_750,1,1,1,0,1
,"",_751,1,1,1,0,1
,"",_752,1,1,1,0,1
,"",_753,1,1,1,0,1
,"",_755,1,1,1,0,1
,"",_756,1,1,1,0,1
,"",_757,1,1,1,0,1
,"",_758,1,1,1,0,1
,"",_760,1,1,1,0,1
,"",_761,1,1,0,0,0
,"",_762,1,1,1,0,1
,"",_763,1,1,1,0,1
,"",_764,1,1,1,0,1
,"",_765,1,1,1,0,1
,"",_766,1,1,1,0,1
,"",_767,1,1,1,0,1
,"",_768,1,1,1,0,1
,"",_769,1,1,1,0,1
,"",_770,1,1,1,0,1
,"",_771,1,1,1,0,1
,"",_772,1,1,1,0,1
,"",_773,1,1,1,0,1
,"",_774,1,1,1,0,1
,"",_775,1,1,1,0,1
,"",_776,1,1,1,0,1
,"",_777,1,1,1,0,1
,"",_778,1,1,1,0,1
,"",_779,1,1,1,0,1
,"",_780,1,1,1,0,1
,"",_781,1,1,1,0,1
,"",_782,1,1,0,0,0
,"",_783,1,1,1,0,1
,"",_784,1,1,1,0,1
,"",_785,1,1,1,0,1
,"",_786,1,1,1,0,1
,"",_787,1,1,1,0,1
,"",_788,1,1,1,0,1
,"",_789,1,1,1,0,1
,"",_790,1,1,1,0,1
,"",_791,1,1,1,0,1
,"",_792,1,1,1,0,1
,"",_793,1,1,1,0,1
,"",_794,1,1,1,0,1
,"",_795,1,1,1,0,1
,"",_796,1,1,1,0,1
,"",_797,1,1,1,0,1
,"",_798,1,1,1,0,1
,"",_799,1,1,1,0,1
,"",_800,1,1,1,0,1
,"",_801,1,1,1,0,1
,"",_802,1,1,1,0,1
,"",_804,1,1,1,0,1
,"",_805,1,1,1,0,1
,"",_806,1,1,1,0,1
,"",_807,1,1,1,0,1
,"",_808,1,1,1,0,1
,"",_809,1,1,1,0,1
,"",_810,1,1,1,0,1
,"",_812,1,1,1,0,1
,"",_813,1,1,1,0,1
,"",_814,1,1,1,0,1
,"",_815,1,1,1,0,1
,"",_816,1,1,1,0,1
,"",_817,1,1,1,0,1
,"",_819,1,1,1,0,1
,"",_820,1,1,1,0,1
,"",_821,1,1,1,0,1
,"",_822,1,1,1,0,1
,"",_824,1,1,1,0,1
,"",_825,1,1,1,0,1
,"",_826,1,1,1,0,1
,"",_827,1,1,0,0,0
,"",_828,1,1,1,0,1
,"",_829,1,1,1,0,1
,"",_830,1,1,1,0,1
,"",_831,1,1,1,0,1
,"",_832,1,1,1,0,1
,"",_833,1,1,1,0,1
,"",_834,1,1,1,0,1
,"",_835,1,1,1,0,1
,"",_836,1,1,1,0,1
,"",_837,1,1,1,0,1
,"",_838,1,1,1,0,1
,"",_839,1,1,1,0,1
,"",_840,1,1,1,0,1
,"",_841,1,1,1,0,1
,"",_842,1,1,1,0,1
,"",_843,1,1,1,0,1
,"",_844,1,1,1,0,1
,"",_845,1,1,1,0,1
,"",_846,1,1,1,0,1
,"",_847,1,1,1,0,1
,"",_848,1,1,1,0,1
,"",_849,1,1,1,0,1
,"",_850,1,1,1,0,1
,"",_851,1,1,0,0,0
,"",_852,1,1,1,0,1
,"",_853,1,1,1,0,1
,"",_854,1,1,1,0,1
,"",_855,1,1,1,0,1
,"",_856,1,1,1,0,1
,"",_857,1,1,1,0,1
,"",_859,1,1,1,0,1
,"",_860,1,1,1,0,1
,"",_861,1,1,1,0,1
,"",_862,1,1,1,0,1
,"",_863,1,1,1,0,1
,"",_864,1,1,1,0,1
,"",_865,1,1,1,0,1
,"",_866,1,1,1,0,1
,"",_867,1,1,1,0,1
,"",_869,1,1,1,0,1
,"",_870,1,1,1,0,1
,"",_871,1,1,1,0,1
,"",_873,1,1,1,0,1
,"",_874,1,1,1,0,1
,"",_876,1,1,1,0,1
,"",_877,1,1,1,0,1
,"",_878,1,1,1,0,1
,"",_880,1,1,1,0,1
,"",_881,1,1,1,0,1
,"",_882,1,1,1,0,1
,"",_883,1,1,0,0,0
,"",_884,1,1,1,0,1
,"",_885,1,1,1,0,1
,"",_886,1,1,1,0,1
,"",_887,1,1,1,0,1
,"",_888,1,1,1,0,1
,"",_889,1,1,1,0,1
,"",_890,1,1,1,0,1
,"",_891,1,1,1,0,1
,"",_893,1,1,0,0,0
,"",_894,1,1,1,0,1
,"",_895,1,1,1,0,1
,"",_896,1,1,1,0,1
,"",_898,1,1,1,0,1
,"",_899,1,1,1,0,1
,"",_900,1,1,1,0,1
,"",_901,1,1,1,0,1
,"",_903,1,1,1,0,1
,"",_905,1,1,1,0,1
,"",_907,1,1,1,0,1
,"",_908,1,1,1,0,1
,"",_909,1,1,1,0,1
,"",_910,1,1,1,0,1
,"",_911,1,1,1,0,1
,"",_912,1,1,1,0,1
,"",_913,1,1,1,0,1
,"",_914,1,1,1,0,1
,"",_915,1,1,1,0,1
,"",_916,1,1,1,0,1
,"",_918,1,1,1,0,1
,"",_919,1,1,1,0,1
,"",_920,1,1,1,0,1
,"",_921,1,1,1,0,1
,"",_923,1,1,1,0,1
,"",_924,1,1,0,0,0
,"",_925,1,1,1,0,1
,"",_926,1,1,1,0,1
,"",_927,1,1,1,0,1
,"",_928,1,1,1,0,1
,"",_929,1,1,1,0,1
,"",_932,1,1,1,0,1
,"",_933,1,1,1,0,1
,"",_935,1,1,1,0,1
,"",_936,1,1,1,0,1
,"",_937,1,1,1,0,1
,"",_938,1,1,0,1,1
,"",_939,1,1,1,0,1
,"",_940,1,1,1,0,1
,"",_941,1,1,1,0,1
,"",_942,1,1,0,0,0
,"",_943,1,1,0,0,0
,"",_944,1,1,1,0,1
,"",_945,1,1,1,0,1
,"",_946,1,1,0,0,0
,"",_947,1,1,0,0,0
,"",_948,1,1,0,0,0
,"",_949,1,1,1,0,1
,"",_950,1,1,1,0,1
,"",_951,1,1,1,0,1
,"",_952,1,1,1,0,1
,"",_953,1,1,1,0,1
,"",_954,1,1,0,0,0
,"",_955,1,1,1,0,1
,"",_956,1,1,1,0,1
,"",_957,1,1,0,1,1
,"",_958,1,1,1,0,1
,"",_959,1,1,1,0,1
,"",_960,1,1,0,0,0
,"",_961,1,1,1,0,1
,"",_962,1,1,0,1,1
,"",_963,1,1,1,0,1
,"",_964,1,1,1,0,1
,"",_965,1,1,1,0,1
,"",_966,1,1,1,0,1
,"",_967,1,1,1,0,1
,"",_968,1,1,1,0,1
,"",_969,1,1,1,0,1
,"",_970,1,1,1,0,1
,"",_971,1,1,0,0,0
,"",_973,1,1,1,0,1
,"",_974,1,1,1,0,1
,"",_976,1,1,1,0,1
,"",_977,1,1,0,0,0
,"",_979,1,1,1,0,1
,"",_980,1,1,1,0,1
,"",_981,1,1,1,0,1
,"",_982,1,1,1,0,1
,"",_983,1,1,1,0,1
,"",_984,1,1,0,0,0
,"",_985,1,1,1,0,1
,"",_986,1,1,1,0,1
,"",_987,1,1,1,0,1
,"",_988,1,1,1,0,1
,"",_989,1,1,1,0,1
,"",_990,1,1,1,0,1
,"",_991,1,1,1,0,1
,"",_992,1,1,1,0,1
,"",_993,1,1,1,0,1
,"",_994,1,1,1,0,1
,"",_995,1,1,1,0,1
,"",_997,1,1,1,0,1
,"",_998,1,1,1,0,1
,"",_999,1,1,1,0,1
,"",_1000,1,1,1,0,1
,"",_1001,1,1,0,0,0
,"",_1002,1,1,1,0,1
,"",_1003,1,1,1,0,1
,"",_1004,1,1,1,0,1
,"",_1005,1,1,1,0,1
,"",_1007,1,1,0,0,0
,"",_1009,1,1,1,0,1
,"",_1011,1,1,1,0,1
,"",_1012,1,1,1,0,1
,"",_1013,1,1,0,0,0
,"",_1014,1,1,1,0,1
,"",_1015,1,1,1,0,1
,"",_1016,1,1,1,0,1
,"",_1017,1,1,1,0,1
,"",_1018,1,1,1,0,1
,"",_1019,1,1,1,0,1
,"",_1020,1,1,1,0,1
,"",_1021,1,1,1,0,1
,"",_1023,1,1,1,0,1
,"",_1024,1,1,1,0,1
,"",_1025,1,1,1,0,1
,"",_1026,1,1,1,0,1
,"",_1027,1,1,1,0,1
,"",_1028,1,1,1,0,1
,"",_1029,1,1,1,0,1
,"",_1030,1,1,1,0,1
,"",_1031,1,1,1,0,1
,"",_1032,1,1,1,0,1
,"",_1033,1,1,1,0,1
,"",_1034,1,1,1,0,1
,"",_1035,1,1,1,0,1
,"",_1036,1,1,1,0,1
,"",_1037,1,1,1,0,1
,"",_1038,1,1,1,0,1
,"",_1039,1,1,1,0,1
,"",_1040,1,1,1,0,1
,"",_1041,1,1,1,0,1
,"",_1042,1,1,1,0,1
,"",_1043,1,1,1,0,1
,"",_1044,1,1,1,0,1
,"",_1045,1,1,1,0,1
,"",_1048,1,1,1,0,1
,"",_1049,1,1,1,0,1
,"",_1050,1,1,1,0,1
,"",_1051,1,1,1,0,1
,"",_1052,1,1,0,0,0
,"",_1053,1,1,1,0,1
,"",_1054,1,1,1,0,1
,"",_1055,1,1,1,0,1
,"",_1056,1,1,1,0,1
,"",_1057,1,1,0,1,1
,"",_1058,1,1,0,1,1
,"",_1059,1,1,1,0,1
,"",_1060,1,1,1,0,1
,"",_1062,1,1,1,0,1
,"",_1063,1,1,0,0,0
,"",_1064,1,1,1,0,1
,"",_1065,1,1,1,0,1
,"",_1067,1,1,1,0,1
,"",_1068,1,1,0,0,0
,"",_1069,1,1,1,0,1
,"",_1070,1,1,1,0,1
,"",_1071,1,1,1,0,1
,"",_1072,1,1,1,0,1
,"",_1073,1,1,1,0,1
,"",_1074,1,1,0,1,1
,"",_1075,1,1,1,0,1
,"",_1076,1,1,1,0,1
,"",_1077,1,1,1,0,1
,"",_1078,1,1,0,0,0
,"",_1079,1,1,1,0,1
,"",_1080,1,1,1,0,1
,"",_1081,1,1,1,0,1
,"",_1082,1,1,1,0,1
,"",_1083,1,1,1,0,1
,"",_1084,1,1,1,0,1
,"",_1085,1,1,1,0,1
,"",_1086,1,1,1,0,1
,"",_1087,1,1,1,0,1
,"",_1088,1,1,1,0,1
,"",_1089,1,1,1,0,1
,"",_1090,1,1,1,0,1
,"",_1091,1,1,1,0,1
,"",_1092,1,1,1,0,1
,"",_1093,1,1,1,0,1
,"",_1094,1,1,1,0,1
,"",_1096,1,1,1,0,1
,"",_1098,1,1,1,0,1
,"",_1099,1,1,1,0,1
,"",_1100,1,1,1,0,1
,"",_1101,1,1,1,0,1
,"",_1102,1,1,1,0,1
,"",_1103,1,1,0,0,0
,"",_1104,1,1,1,0,1
,"",_1105,1,1,1,0,1
,"",_1106,1,1,1,0,1
,"",_1107,1,1,1,0,1
,"",_1108,1,1,1,0,1
,"",_1109,1,1,1,0,1
,"",_1110,1,1,1,0,1
,"",_1112,1,1,1,0,1
,"",_1113,1,1,1,0,1
,"",_1114,1,1,1,0,1
,"",_1115,1,1,1,0,1
,"",_1116,1,1,1,0,1
,"",_1117,1,1,1,0,1
,"",_1118,1,1,1,0,1
,"",_1119,1,1,1,0,1
,"",_1120,1,1,1,0,1
,"",_1121,1,1,0,1,1
,"",_1122,1,1,1,0,1
,"",_1123,1,1,1,0,1
,"",_1124,1,1,1,0,1
,"",_1125,1,1,1,0,1
,"",_1126,1,1,1,0,1
,"",_1127,1,1,1,0,1
,"",_1128,1,1,1,0,1
,"",_1129,1,1,1,0,1
,"",_1130,1,1,1,0,1
,"",_1131,1,1,1,0,1
,"",_1132,1,1,1,0,1
,"",_1134,1,1,1,0,1
,"",_1135,1,1,1,0,1
,"",_1136,1,1,1,0,1
,"",_1137,1,1,1,0,1
,"",_1138,1,1,1,0,1
,"",_1139,1,1,1,0,1
,"",_1140,1,1,1,0,1
,"",_1142,1,1,1,0,1
,"",_1143,1,1,1,0,1
,"",_1144,1,1,1,0,1
,"",_1145,1,1,1,0,1
,"",_1146,1,1,1,0,1
,"",_1147,1,1,1,0,1
,"",_1149,1,1,1,0,1
,"",_1150,1,1,1,0,1
,"",_1151,1,1,1,0,1
,"",_1152,1,1,1,0,1
,"",_1153,1,1,1,0,1
,"",_1154,1,1,1,0,1
,"",_1155,1,1,1,0,1
,"",_1156,1,1,1,0,1
,"",_1157,1,1,1,0,1
,"",_1158,1,1,1,0,1
,"",_1159,1,1,1,0,1
,"",_1160,1,1,1,0,1
,"",_1161,1,1,1,0,1
,"",_1162,1,1,1,0,1
,"",_1163,1,1,1,0,1
,"",_1164,1,1,1,0,1
,"",_1165,1,1,1,0,1
,"",_1166,1,1,1,0,1
,"",_1167,1,1,1,0,1
,"",_1169,1,1,1,0,1
,"",_1170,1,1,1,0,1
,"",_1171,1,1,0,0,0
,"",_1172,1,1,1,0,1
,"",_1173,1,1,1,0,1
,"",_1174,1,1,1,0,1
,"",_1175,1,1,1,0,1
,"",_1176,1,1,1,0,1
,"",_1177,1,1,1,0,1
,"",_1178,1,1,1,0,1
,"",_1180,1,1,1,0,1
,"",_1181,1,1,1,0,1
,"",_1182,1,1,1,0,1
,"",_1183,1,1,1,0,1
,"",_1185,1,1,1,0,1
,"",_1186,1,1,1,0,1
,"",_1187,1,1,1,0,1
,"",_1188,1,1,1,0,1
,"",_1189,1,1,1,0,1
,"",_1190,1,1,1,0,1
,"",_1191,1,1,1,0,1
,"",_1192,1,1,1,0,1
,"",_1193,1,1,1,0,1
,"",_1194,1,1,1,0,1
,"",_1195,1,1,1,0,1
,"",_1196,1,1,1,0,1
,"",_1198,1,1,0,0,0
,"",_1199,1,1,0,0,0
,"",_1200,1,1,0,0,0
,"",_1201,1,1,1,0,1
,"",_1202,1,1,1,0,1
,"",_1203,1,1,1,0,1
,"",_1204,1,1,1,0,1
,"",_1205,1,1,1,0,1
,"",_1206,1,1,1,0,1
,"",_1207,1,1,1,0,1
,"",_1208,1,1,1,0,1
,"",_1209,1,1,0,0,0
,"",_1210,1,1,1,0,1
,"",_1211,1,1,1,0,1
,"",_1212,1,1,1,0,1
,"",_1213,1,1,1,0,1
,"",_1215,1,1,1,0,1
,"",_1216,1,1,1,0,1
,"",_1217,1,1,1,0,1
,"",_1218,1,1,1,0,1
,"",_1219,1,1,1,0,1
,"",_1220,1,1,1,0,1
,"",_1221,1,1,1,0,1
,"",_1222,1,1,1,0,1
,"",_1223,1,1,1,0,1
,"",_1224,1,1,1,0,1
,"",_1225,1,1,1,0,1
,"",_1226,1,1,1,0,1
,"",_1227,1,1,1,0,1
,"",_1228,1,1,1,0,1
,"",_1229,1,1,1,0,1
,"",_1230,1,1,1,0,1
,"",_1231,1,1,1,0,1
,"",_1232,1,1,1,0,1
,"",_1233,1,1,1,0,1
,"",_1234,1,1,1,0,1
,"",_1235,1,1,1,0,1
,"",_1236,1,1,1,0,1
,"",_1237,1,1,1,0,1
,"",_1238,1,1,1,0,1
,"",_1239,1,1,1,0,1
,"",_1240,1,1,1,0,1
,"",_1241,1,1,1,0,1
,"",_1242,1,1,1,0,1
,"",_1243,1,1,1,0,1
,"",_1244,1,1,1,0,1
,"",_1245,1,1,1,0,1
,"",_1246,1,1,0,0,0
,"",_1247,1,1,1,0,1
,"",_1248,1,1,1,0,1
,"",_1249,1,1,1,0,1
,"",_1250,1,1,1,0,1
,"",_1251,1,1,0,1,1
,"",_1252,1,1,1,0,1
,"",_1253,1,1,1,0,1
,"",_1254,1,1,1,0,1
,"",_1255,1,1,1,0,1
,"",_1256,1,1,1,0,1
,"",_1257,1,1,1,0,1
,"",_1258,1,1,1,0,1
,"",_1259,1,1,1,0,1
,"",_1260,1,1,1,0,1
,"",_1261,1,1,0,0,0
,"",_1262,1,1,1,0,1
,"",_1264,1,1,1,0,1
,"",_1265,1,1,1,0,1
,"",_1266,1,1,1,0,1
,"",_1267,1,1,1,0,1
,"",_1268,1,1,1,0,1
,"",_1269,1,1,1,0,1
,"",_1270,1,1,1,0,1
,"",_1271,1,1,1,0,1
,"",_1272,1,1,1,0,1
,"",_1273,1,1,1,0,1
,"",_1274,1,1,1,0,1
,"",_1275,1,1,0,0,0
,"",_1276,1,1,1,0,1
,"",_1277,1,1,1,0,1
,"",_1278,1,1,0,1,1
,"",_1279,1,1,1,0,1
,"",_1280,1,1,1,0,1
,"",_1281,1,1,1,0,1
,"",_1282,1,1,1,0,1
,"",_1283,1,1,1,0,1
,"",_1284,1,1,1,0,1
,"",_1285,1,1,1,0,1
,"",_1286,1,1,1,0,1
,"",_1287,1,1,1,0,1
,"",_1288,1,1,1,0,1
,"",_1290,1,1,1,0,1
,"",_1291,1,1,1,0,1
,"",_1292,1,1,1,0,1
,"",_1293,1,1,1,0,1
,"",_1294,1,1,1,0,1
,"",_1295,1,1,1,0,1
,"",_1296,1,1,1,0,1
,"",_1297,1,1,1,0,1
,"",_1298,1,1,1,0,1
,"",_1299,1,1,0,0,0
,"",_1300,1,1,1,0,1
,"",_1301,1,1,1,0,1
,"",_1302,1,1,1,0,1
,"",_1303,1,1,0,1,1
,"",_1304,1,1,1,0,1
,"",_1305,1,1,1,0,1
,"",_1306,1,1,1,0,1
,"",_1307,1,1,1,0,1
,"",_1308,1,1,1,0,1
,"",_1309,1,1,1,0,1
,"",_1310,1,1,1,0,1
,"",_1311,1,1,1,0,1
,"",_1312,1,1,1,0,1
,"",_1313,1,1,1,0,1
,"",_1314,1,1,1,0,1
,"",_1315,1,1,1,0,1
,"",_1316,1,1,1,0,1
,"",_1317,1,1,1,0,1
,"",_1318,1,1,1,0,1
,"",_1319,1,1,1,0,1
,"",_1320,1,1,1,0,1
,"",_1321,1,1,1,0,1
,"",_1322,1,1,1,0,1
,"",_1323,1,1,1,0,1
,"",_1324,1,1,1,0,1
,"",_1325,1,1,1,0,1
,"",_1326,1,1,1,0,1
,"",_1328,1,1,1,0,1
,"",_1329,1,1,1,0,1
,"",_1330,1,1,1,0,1
,"",_1331,1,1,1,0,1
,"",_1332,1,1,1,0,1
,"",_1333,1,1,1,0,1
,"",_1335,1,1,1,0,1
,"",_1336,1,1,1,0,1
,"",_1337,1,1,1,0,1
,"",_1338,1,1,1,0,1
,"",_1339,1,1,1,0,1
,"",_1340,1,1,1,0,1
,"",_1342,1,1,1,0,1
,"",_1343,1,1,1,0,1
,"",_1345,1,1,1,0,1

