Name,Description,Combined Group,Unique Machines,Unique UserID, Count F,Count H,EULA Machines
Gear Inc,"https://genesis.hq.unity3d.com/organizations/2018388/
 https://genesis.hq.unity3d.com/organizations/18966625056278/
https://genesis.hq.unity3d.com/users/4690573/
 https://genesis.hq.unity3d.com/users/18966593843202/
https://genesis.hq.unity3d.com/users/2426110/
 https://genesis.hq.unity3d.com/users/18966715582496/
https://genesis.hq.unity3d.com/organizations/2018388/
 https://genesis.hq.unity3d.com/users/18966717349063/

",_9,56,47,40,7,47
ABI - Onesoft,"https://genesis.hq.unity3d.com/users/2330878/
 hungtm@onesoft.com.vn
https://genesis.hq.unity3d.com/organizations/18966592459647/
 http://thaidong.com.vn/

",_2,51,39,28,19,47
Amanotes,"https://genesis.hq.unity3d.com/users/18966721915092/
 https://genesis.hq.unity3d.com/organizations/3578764/
https://genesis.hq.unity3d.com/organizations/18966700642687/
 https://genesis.hq.unity3d.com/users/18966715382989/

",_3,38,28,26,1,27
Gameloft,"https://genesis.hq.unity3d.com/organizations/9071028540679/
 https://genesis.hq.unity3d.com/organizations/9071028540679/members-groups

",_1,34,28,14,1,15
Kien Giang College,"http://www.kgc.edu.vn/
 https://genesis.hq.unity3d.com/users/18966860832420/
https://genesis.hq.unity3d.com/users/18966782490723/
 https://genesis.hq.unity3d.com/users/18966724251809/
https://genesis.hq.unity3d.com/users/18966860878757/
 https://genesis.hq.unity3d.com/users/18966860845704/

",_5,31,26,31,0,31
Rocket - Onesoft,"https://genesis.hq.unity3d.com/organizations/17867065208868/
https://genesis.hq.unity3d.com/users/18966755140055/
 https://genesis.hq.unity3d.com/users/18966717410526/
https://genesis.hq.unity3d.com/users/18966793550851/

",_13,30,21,12,16,28
Onesoft - Falcon,"https://genesis.hq.unity3d.com/users/18966595375480/
 https://genesis.hq.unity3d.com/organizations/18966595375483/members-groups
https://genesis.hq.unity3d.com/users/18966691210282/
 https://play.google.com/store/apps/dev?id=7627571908184472902

",_10,25,18,16,5,21
Imba Game Studio,"https://genesis.hq.unity3d.com/organizations/786901/
 https://thesugagroup.com/
https://imba.co/

",_4,25,21,21,1,22
Zitga,"https://genesis.hq.unity3d.com/organizations/3606368/
 https://genesis.hq.unity3d.com/users/5701336/

",_14,24,18,19,5,24
VNG,"https://genesis.hq.unity3d.com/organizations/18966653606491/
https://play.google.com/store/apps/dev?id=5261964832059401451
 https://genesis.hq.unity3d.com/organizations/93316/
https://genesis.hq.unity3d.com/organizations/20066132969623/
 https://genesis.hq.unity3d.com/users/20066140312855/
https://genesis.hq.unity3d.com/users/20066132969620/

",_28,23,21,18,3,21
inwave game studio,"https://genesis.hq.unity3d.com/users/20066127856832/
 https://genesis.hq.unity3d.com/organizations/20066127856835/
https://www.facebook.com/pages/category/Gaming-Video-Creator/Inwave-Studio-889367298089921/
Linked with Amanotes

",_17,22,16,13,6,19
GoGame,"https://gogame.net/
 https://genesis.hq.unity3d.com/organizations/18966797729143/
https://genesis.hq.unity3d.com/organizations/16767555183560/
 https://genesis.hq.unity3d.com/organizations/18966602244131/

",_21,22,20,18,0,18
Antada,"",_46,22,17,21,1,22
https://fireholderstudio.com/,"https://genesis.hq.unity3d.com/users/18966839267173/
 https://genesis.hq.unity3d.com/organizations/18966839267179/

",_8,21,16,15,6,21
OneTech Asia JSC,"https://genesis.hq.unity3d.com/organizations/18966610878077/
https://genesis.hq.unity3d.com/users/6341275/
 https://onetech.vn/recruit

",_15,20,13,17,0,17
BraveStars - Zonmob,"https://genesis.hq.unity3d.com/organizations/18966594999013/
https://genesis.hq.unity3d.com/users/18966801388677/
 https://genesis.hq.unity3d.com/users/18966777587490/
https://genesis.hq.unity3d.com/users/18966737903339/
 https://genesis.hq.unity3d.com/users/6605393/
https://genesis.hq.unity3d.com/users/18966775518498/

",_22,19,18,17,1,18
The Corgi Team,"https://genesis.hq.unity3d.com/organizations/2044079/
 https://genesis.hq.unity3d.com/organizations/2043853/

",_11,17,12,16,0,16
iKame,"https://genesis.hq.unity3d.com/organizations/636727/
 https://genesis.hq.unity3d.com/organizations/18966600201681/projects/c8920e89-cbf2-4787-bef6-43d9f2c108a3#members
https://genesis.hq.unity3d.com/users/3795970/
 https://genesis.hq.unity3d.com/organizations/18966600201681/

",_19,17,13,11,6,17
Goodia,"https://genesis.hq.unity3d.com/organizations/2257223/
 https://genesis.hq.unity3d.com/organizations/570784/
http://goodia.co.jp/
 https://genesis.hq.unity3d.com/users/2914396/
 https://genesis.hq.unity3d.com/organizations/1493310/
https://genesis.hq.unity3d.com/organizations/20066131252378/

",_56,17,15,15,1,16
Asean Fan - Grateful Days,"http://aseanfan.com/
 https://genesis.hq.unity3d.com/organizations/307628/
https://genesis.hq.unity3d.com/users/85629/
 https://genesis.hq.unity3d.com/users/2128211/
https://genesis.hq.unity3d.com/users/18966770312613/

",_39,15,9,14,1,15
AltPlus,"https://altplus.com.vn/
 https://genesis.hq.unity3d.com/organizations/165838/
https://genesis.hq.unity3d.com/users/18966732574482/
 https://genesis.hq.unity3d.com/organizations/18966732574487/members-groups
https://genesis.hq.unity3d.com/organizations/18966851933475/members-groups

",_25,14,11,12,2,14
Punch Entertainment,"Punch.vn
 https://genesis.hq.unity3d.com/organizations/18966598966767/
https://genesis.hq.unity3d.com/users/18966845990896/
 https://genesis.hq.unity3d.com/users/18966864718842/
Sun Monkey Studio
 https://genesis.hq.unity3d.com/organizations/18966593979293/
Looks like a dev that is working at Punch also own a separate business
 https://genesis.hq.unity3d.com/users/18966593979290/

",_42,13,10,9,4,13
No Power Up,"https://genesis.hq.unity3d.com/organizations/2383068/
 https://genesis.hq.unity3d.com/organizations/2383053/
https://ptt-solution.com/contact-us
 https://genesis.hq.unity3d.com/users/4952020/
https://genesis.hq.unity3d.com/organizations/18966635591314/
 https://genesis.hq.unity3d.com/users/18966635591310/

",_34,13,7,11,0,11
https://genesis.hq.unity3d.com/organizations/18966779183240/,"https://genesis.hq.unity3d.com/organizations/18966696130162/

",_12,13,11,8,4,12
BAP Software,"https://bap-software.net/en/
 https://genesis.hq.unity3d.com/organizations/4113619/
https://genesis.hq.unity3d.com/users/6190043/

",_7,13,9,11,0,11
KixEye,"https://genesis.hq.unity3d.com/organizations/86950/
 https://genesis.hq.unity3d.com/users/18966737800202/
https://genesis.hq.unity3d.com/users/4366219/

",_27,12,12,5,0,5
GIANTY Inc - GNT VN,"https://genesis.hq.unity3d.com/organizations/18966672819082/
https://genesis.hq.unity3d.com/organizations/18966672819082/members-groups
https://genesis.hq.unity3d.com/users/1784339/

",_35,12,8,11,0,11
Le Quy Don University,"https://genesis.hq.unity3d.com/organizations/18966799119428/
https://genesis.hq.unity3d.com/organizations/3076357/

",_141,11,9,5,6,11
IMOSYS - Onesoft,"https://imosys.net/
 https://genesis.hq.unity3d.com/users/18966758539923/
https://genesis.hq.unity3d.com/users/18966864761646/

",_38,11,11,6,5,11
Hiker Games,"https://genesis.hq.unity3d.com/users/712131/
 https://genesis.hq.unity3d.com/organizations/412949/
https://genesis.hq.unity3d.com/organizations/2588527/
 https://genesis.hq.unity3d.com/organizations/4442783/

",_18,11,9,5,0,5
Dai Hoc Da Lat,"Nicolas working place
 http://dlu.edu.vn/
 https://genesis.hq.unity3d.com/users/18966865446740/

",_59,11,11,11,0,11
CSC Mobi,"",_45,11,7,6,5,11
teamobi.vn,"http://teamobi.vn/home/home-page.html
 https://genesis.hq.unity3d.com/organizations/152990/
https://genesis.hq.unity3d.com/users/233464/

",_60,10,8,5,4,9
Flow Motion Entertainment,"flowmotionentertainment.com
 https://genesis.hq.unity3d.com/organizations/2486312/
https://genesis.hq.unity3d.com/users/3493108/
 https://genesis.hq.unity3d.com/users/3014296/

",_30,10,4,1,4,5
Athena,"https://genesis.hq.unity3d.com/organizations/1374429426877/
 https://genesis.hq.unity3d.com/organizations/18966766433521/
https://genesis.hq.unity3d.com/organizations/18966733399785/
 https://genesis.hq.unity3d.com/organizations/18966653466577/
https://genesis.hq.unity3d.com/users/1374429426874/

",_31,10,9,9,1,10
Weegoon,"https://genesis.hq.unity3d.com/organizations/18966727616399/
https://genesis.hq.unity3d.com/users/18966768809198/
 https://genesis.hq.unity3d.com/users/18966727616394/

",_85,9,6,5,4,9
Topebox,"https://genesis.hq.unity3d.com/organizations/2182327/
 https://genesis.hq.unity3d.com/organizations/18966796068481/
https://genesis.hq.unity3d.com/organizations/2182307/
 https://genesis.hq.unity3d.com/organizations/18966802506978/

",_23,9,9,6,0,6
SGLib games,"https://genesis.hq.unity3d.com/users/1374437212999/
 https://genesis.hq.unity3d.com/organizations/1143152/
https://genesis.hq.unity3d.com/organizations/18966594458917/

",_26,9,7,7,0,7
Kaopiz Software Co Ltd,"Outsourcing company

",_104,9,7,7,1,8
Grep Game,"https://grepgame.com/
 https://genesis.hq.unity3d.com/users/18966712182958/
https://genesis.hq.unity3d.com/users/4134640/

",_40,9,7,9,0,9
Fitin,"https://genesis.hq.unity3d.com/users/18966858018930/
 https://genesis.hq.unity3d.com/organizations/18966858018935/
https://genesis.hq.unity3d.com/organizations/126509/
 https://genesis.hq.unity3d.com/users/454657/
dung.dinh.nguyen@fitin.vn

",_58,9,8,5,4,9
,"",_65,9,5,9,0,9
Mecury Studio,"Game Studio / Oursourcing
 Hiring Unity devs
 https://genesis.hq.unity3d.com/organizations/577017/
https://genesis.hq.unity3d.com/users/3560761/

",_170,8,7,6,0,6
BBGames Studio,"https://genesis.hq.unity3d.com/users/5089087/
 https://genesis.hq.unity3d.com/organizations/2591852/
https://genesis.hq.unity3d.com/users/18966711899545/

",_37,8,7,7,0,7
Vkids,"https://play.google.com/store/apps/developer?id=VKids&hl=en
 https://genesis.hq.unity3d.com/users/5469026/
https://vkidsapp.com/

",_72,7,6,5,1,6
Simulation.vn,"",_67,7,7,7,0,7
PeopleSQ,"https://genesis.hq.unity3d.com/organizations/2473944758381/
 http://playboostnow.com/
https://genesis.hq.unity3d.com/users/2473944758377/
 ASNET
 https://genesis.hq.unity3d.com/organizations/10750/
Looks like ASNET is doing outsourcing work for PeopleSQ
 https://genesis.hq.unity3d.com/users/2909886/

",_122,7,5,6,0,6
,"",_20,7,6,6,0,6
,"",_61,7,5,5,0,5
,"",_80,7,4,6,0,6
,"",_86,7,5,2,1,3
,"",_126,7,4,7,0,7
,"",_171,7,3,5,2,7
,"",_33,6,5,6,0,6
,"",_41,6,4,6,0,6
,"",_57,6,2,0,6,6
,"",_81,6,5,5,0,5
,"",_89,6,3,6,0,6
,"",_93,6,5,5,1,6
,"",_97,6,4,1,5,6
,"",_99,6,6,5,1,6
,"",_123,6,3,6,0,6
Rollbox Studio,"https://genesis.hq.unity3d.com/organizations/1374448055350/

",_29,5,5,5,0,5
MINTPOT VINA COMPANY,"https://genesis.hq.unity3d.com/organizations/18966869912995/

",_109,5,4,4,1,5
,"",_50,5,3,3,0,3
,"",_54,5,4,5,0,5
,"",_66,5,3,3,0,3
,"",_76,5,4,5,0,5
,"",_78,5,4,1,0,1
,"",_79,5,4,3,0,3
,"",_87,5,4,5,0,5
,"",_91,5,4,5,0,5
,"",_94,5,4,5,0,5
,"",_98,5,4,5,0,5
,"",_111,5,2,4,1,5
,"",_114,5,3,4,0,4
,"",_119,5,3,4,0,4
,"",_120,5,5,3,2,5
,"",_129,5,3,3,2,5
,"",_168,5,4,2,0,2
,"",_173,5,4,4,0,4
,"",_177,5,4,5,0,5
,"",_196,5,3,1,4,5
,"",_48,4,4,2,0,2
,"",_55,4,3,1,3,4
,"",_62,4,4,4,0,4
,"",_73,4,2,4,0,4
,"",_83,4,3,4,0,4
,"",_100,4,3,4,0,4
,"",_107,4,2,2,0,2
,"",_110,4,4,4,0,4
,"",_112,4,2,0,4,4
,"",_115,4,4,4,0,4
,"",_116,4,4,1,3,4
,"",_118,4,4,4,0,4
,"",_128,4,2,3,1,4
,"",_131,4,2,2,0,2
,"",_132,4,3,3,0,3
,"",_143,4,3,2,2,4
,"",_147,4,1,4,0,4
,"",_148,4,3,2,0,2
,"",_150,4,3,0,4,4
,"",_152,4,2,1,3,4
,"",_155,4,3,4,0,4
,"",_158,4,4,4,0,4
,"",_167,4,3,2,0,2
,"",_255,4,3,3,1,4
,"",_273,4,1,4,0,4
,"",_274,4,3,4,0,4
,"",_277,4,2,3,1,4
,"",_301,4,2,4,0,4
,"",_303,4,2,4,0,4
,"",_305,4,2,4,0,4
,"",_307,4,2,0,4,4
,"",_356,4,2,1,3,4
https://cubicegg.asia/en/portfolio_en/,"",_162,3,3,3,0,3
ftech.ai,"https://genesis.hq.unity3d.com/organizations/2151846/ https://genesis.hq.unity3d.com/users/4793388/

",_357,3,2,3,0,3
Caerux,"http://www.caerux.com/
 https://genesis.hq.unity3d.com/organizations/1380658/
https://genesis.hq.unity3d.com/users/708497/

",_84,3,3,3,0,3
,"",_52,3,1,3,0,3
,"",_53,3,3,1,2,3
,"",_64,3,2,1,0,1
,"",_71,3,2,3,0,3
,"",_74,3,3,3,0,3
,"",_75,3,3,2,1,3
,"",_82,3,3,3,0,3
,"",_90,3,3,1,0,1
,"",_103,3,3,0,3,3
,"",_106,3,3,2,0,2
,"",_113,3,2,1,2,3
,"",_121,3,3,3,0,3
,"",_127,3,1,2,1,3
,"",_134,3,3,2,0,2
,"",_138,3,2,2,0,2
,"",_142,3,2,2,0,2
,"",_149,3,3,2,0,2
,"",_154,3,1,3,0,3
,"",_161,3,2,3,0,3
,"",_163,3,3,3,0,3
,"",_164,3,3,3,0,3
,"",_165,3,2,3,0,3
,"",_166,3,1,3,0,3
,"",_169,3,3,3,0,3
,"",_174,3,2,3,0,3
,"",_183,3,2,3,0,3
,"",_190,3,2,3,0,3
,"",_191,3,2,3,0,3
,"",_192,3,1,3,0,3
,"",_195,3,1,3,0,3
,"",_200,3,3,3,0,3
,"",_211,3,3,2,1,3
,"",_217,3,2,3,0,3
,"",_232,3,3,0,3,3
,"",_234,3,2,2,0,2
,"",_248,3,2,3,0,3
,"",_250,3,2,3,0,3
,"",_252,3,3,3,0,3
,"",_258,3,2,3,0,3
,"",_260,3,2,1,0,1
,"",_275,3,3,1,0,1
,"",_276,3,3,3,0,3
,"",_280,3,1,1,2,3
,"",_281,3,1,3,0,3
,"",_294,3,1,3,0,3
,"",_300,3,2,3,0,3
,"",_302,3,2,3,0,3
,"",_304,3,3,1,1,2
,"",_308,3,2,3,0,3
,"",_404,3,2,2,0,2
,"",_423,3,2,3,0,3
,"",_441,3,1,3,0,3
,"",_472,3,2,3,0,3
,"",_478,3,2,2,0,2
,"",_498,3,2,3,0,3
,"",_509,3,1,3,0,3
,"",_535,3,2,3,0,3
,"",_560,3,2,3,0,3
,"",_640,3,2,2,0,2
,"",_658,3,1,3,0,3
,"",_850,3,1,3,0,3
,"",_1338,3,1,3,0,3
PortCoast,"https://genesis.hq.unity3d.com/organizations/18966781379716/
https://genesis.hq.unity3d.com/users/18966781379710/

",_175,2,1,1,0,1
,"",_49,2,2,2,0,2
,"",_68,2,3,2,0,2
,"",_105,2,2,2,0,2
,"",_108,2,2,2,0,2
,"",_117,2,3,2,0,2
,"",_125,2,2,1,0,1
,"",_130,2,1,2,0,2
,"",_135,2,1,0,0,0
,"",_136,2,2,0,2,2
,"",_137,2,1,2,0,2
,"",_140,2,2,1,0,1
,"",_145,2,2,2,0,2
,"",_151,2,1,2,0,2
,"",_156,2,2,2,0,2
,"",_157,2,2,2,0,2
,"",_159,2,2,2,0,2
,"",_172,2,2,2,0,2
,"",_178,2,2,2,0,2
,"",_182,2,2,2,0,2
,"",_184,2,2,2,0,2
,"",_187,2,2,2,0,2
,"",_197,2,1,2,0,2
,"",_199,2,1,2,0,2
,"",_201,2,2,1,1,2
,"",_205,2,2,1,0,1
,"",_213,2,1,2,0,2
,"",_216,2,2,2,0,2
,"",_218,2,1,2,0,2
,"",_219,2,1,2,0,2
,"",_226,2,2,2,0,2
,"",_236,2,2,0,2,2
,"",_237,2,2,1,0,1
,"",_238,2,2,2,0,2
,"",_241,2,1,2,0,2
,"",_243,2,2,2,0,2
,"",_244,2,2,1,1,2
,"",_245,2,2,2,0,2
,"",_249,2,2,2,0,2
,"",_253,2,2,1,0,1
,"",_254,2,2,2,0,2
,"",_265,2,1,0,0,0
,"",_271,2,1,2,0,2
,"",_272,2,2,2,0,2
,"",_283,2,1,2,0,2
,"",_285,2,2,2,0,2
,"",_288,2,2,2,0,2
,"",_289,2,2,1,1,2
,"",_292,2,1,2,0,2
,"",_293,2,2,2,0,2
,"",_296,2,2,2,0,2
,"",_309,2,2,2,0,2
,"",_313,2,2,2,0,2
,"",_316,2,2,2,0,2
,"",_321,2,2,2,0,2
,"",_325,2,1,2,0,2
,"",_333,2,1,2,0,2
,"",_334,2,2,2,0,2
,"",_335,2,1,2,0,2
,"",_340,2,1,2,0,2
,"",_341,2,1,2,0,2
,"",_347,2,2,1,1,2
,"",_352,2,1,2,0,2
,"",_353,2,1,2,0,2
,"",_354,2,2,2,0,2
,"",_355,2,2,2,0,2
,"",_359,2,1,1,0,1
,"",_362,2,1,2,0,2
,"",_363,2,2,2,0,2
,"",_364,2,1,2,0,2
,"",_367,2,2,2,0,2
,"",_369,2,1,2,0,2
,"",_371,2,2,2,0,2
,"",_381,2,2,1,0,1
,"",_387,2,1,1,0,1
,"",_393,2,2,2,0,2
,"",_394,2,2,2,0,2
,"",_403,2,1,2,0,2
,"",_407,2,1,2,0,2
,"",_414,2,2,2,0,2
,"",_416,2,1,2,0,2
,"",_420,2,1,2,0,2
,"",_424,2,1,2,0,2
,"",_425,2,1,2,0,2
,"",_433,2,2,1,1,2
,"",_434,2,1,2,0,2
,"",_435,2,1,1,1,2
,"",_436,2,1,2,0,2
,"",_438,2,1,0,2,2
,"",_439,2,1,0,0,0
,"",_440,2,1,2,0,2
,"",_442,2,1,1,1,2
,"",_443,2,2,1,0,1
,"",_447,2,1,2,0,2
,"",_457,2,1,2,0,2
,"",_459,2,1,2,0,2
,"",_460,2,1,2,0,2
,"",_463,2,1,2,0,2
,"",_464,2,1,1,0,1
,"",_473,2,1,2,0,2
,"",_474,2,2,2,0,2
,"",_482,2,2,2,0,2
,"",_490,2,1,2,0,2
,"",_492,2,2,2,0,2
,"",_502,2,2,2,0,2
,"",_514,2,1,2,0,2
,"",_515,2,1,2,0,2
,"",_520,2,1,2,0,2
,"",_523,2,1,2,0,2
,"",_528,2,2,2,0,2
,"",_530,2,2,2,0,2
,"",_533,2,2,2,0,2
,"",_540,2,1,2,0,2
,"",_546,2,1,2,0,2
,"",_547,2,1,2,0,2
,"",_550,2,1,2,0,2
,"",_552,2,1,2,0,2
,"",_554,2,1,2,0,2
,"",_559,2,1,2,0,2
,"",_562,2,1,2,0,2
,"",_563,2,2,2,0,2
,"",_564,2,1,2,0,2
,"",_565,2,1,2,0,2
,"",_568,2,2,2,0,2
,"",_571,2,2,1,0,1
,"",_579,2,1,2,0,2
,"",_586,2,1,2,0,2
,"",_587,2,2,2,0,2
,"",_588,2,1,2,0,2
,"",_590,2,1,2,0,2
,"",_593,2,2,2,0,2
,"",_594,2,2,1,0,1
,"",_598,2,2,2,0,2
,"",_601,2,2,0,2,2
,"",_603,2,2,2,0,2
,"",_605,2,1,2,0,2
,"",_608,2,2,0,2,2
,"",_611,2,2,2,0,2
,"",_612,2,1,2,0,2
,"",_615,2,2,2,0,2
,"",_617,2,1,0,2,2
,"",_618,2,2,2,0,2
,"",_620,2,1,2,0,2
,"",_625,2,1,2,0,2
,"",_627,2,1,2,0,2
,"",_635,2,1,0,2,2
,"",_647,2,1,2,0,2
,"",_657,2,1,2,0,2
,"",_660,2,2,2,0,2
,"",_661,2,2,1,1,2
,"",_663,2,1,2,0,2
,"",_666,2,1,2,0,2
,"",_667,2,2,2,0,2
,"",_682,2,1,2,0,2
,"",_695,2,1,1,0,1
,"",_700,2,1,2,0,2
,"",_739,2,1,2,0,2
,"",_794,2,1,2,0,2
,"",_830,2,1,2,0,2
,"",_839,2,1,2,0,2
,"",_849,2,1,2,0,2
,"",_896,2,1,2,0,2
,"",_915,2,1,2,0,2
,"",_922,2,1,2,0,2
,"",_923,2,1,2,0,2
,"",_931,2,1,2,0,2
,"",_992,2,1,0,2,2
,"",_994,2,1,2,0,2
,"",_996,2,1,0,2,2
,"",_1012,2,1,2,0,2
,"",_1059,2,1,2,0,2
,"",_1072,2,1,2,0,2
,"",_1108,2,1,2,0,2
,"",_1119,2,1,2,0,2
,"",_1122,2,1,2,0,2
,"",_1126,2,1,2,0,2
,"",_1135,2,1,2,0,2
,"",_1143,2,1,2,0,2
,"",_1149,2,1,2,0,2
,"",_1155,2,1,2,0,2
,"",_1161,2,1,2,0,2
,"",_1179,2,1,2,0,2
,"",_1234,2,1,2,0,2
,"",_1570,2,1,2,0,2
,"",_1741,2,1,2,0,2
,"",_1750,2,1,1,0,1
,"",_1889,2,1,2,0,2
,"",_1955,2,1,2,0,2
,"",_2035,2,1,2,0,2
,"",_2054,2,1,2,0,2
,"",_2112,2,1,2,0,2
,"",_2160,2,1,2,0,2
,"",_2328,2,1,2,0,2
,"",_2365,2,1,2,0,2
https://tohsoft.com/en/,"",_1929,1,1,1,0,1
,"",_24,1,1,0,1,1
,"",_43,1,1,1,0,1
,"",_92,1,1,0,1,1
,"",_95,1,1,1,0,1
,"",_124,1,1,1,0,1
,"",_139,1,1,0,0,0
,"",_144,1,1,1,0,1
,"",_146,1,1,1,0,1
,"",_153,1,1,1,0,1
,"",_160,1,1,1,0,1
,"",_179,1,1,1,0,1
,"",_180,1,1,1,0,1
,"",_186,1,1,1,0,1
,"",_188,1,1,1,0,1
,"",_189,1,1,1,0,1
,"",_193,1,1,1,0,1
,"",_198,1,1,1,0,1
,"",_202,1,1,1,0,1
,"",_206,1,1,1,0,1
,"",_207,1,2,1,0,1
,"",_208,1,1,1,0,1
,"",_209,1,2,1,0,1
,"",_210,1,1,1,0,1
,"",_212,1,1,1,0,1
,"",_214,1,1,1,0,1
,"",_215,1,1,1,0,1
,"",_220,1,1,0,1,1
,"",_221,1,1,1,0,1
,"",_222,1,1,1,0,1
,"",_224,1,1,1,0,1
,"",_225,1,1,1,0,1
,"",_227,1,1,1,0,1
,"",_229,1,1,1,0,1
,"",_230,1,1,1,0,1
,"",_231,1,1,1,0,1
,"",_233,1,1,1,0,1
,"",_239,1,1,1,0,1
,"",_242,1,2,1,0,1
,"",_246,1,1,1,0,1
,"",_247,1,1,1,0,1
,"",_251,1,1,1,0,1
,"",_257,1,1,1,0,1
,"",_259,1,1,1,0,1
,"",_262,1,1,1,0,1
,"",_266,1,1,1,0,1
,"",_267,1,1,0,1,1
,"",_268,1,1,1,0,1
,"",_270,1,1,1,0,1
,"",_278,1,1,1,0,1
,"",_279,1,1,1,0,1
,"",_282,1,1,1,0,1
,"",_284,1,1,1,0,1
,"",_286,1,1,1,0,1
,"",_287,1,1,1,0,1
,"",_290,1,1,1,0,1
,"",_295,1,1,1,0,1
,"",_297,1,1,1,0,1
,"",_298,1,1,1,0,1
,"",_299,1,1,0,1,1
,"",_306,1,1,1,0,1
,"",_310,1,1,1,0,1
,"",_311,1,1,1,0,1
,"",_312,1,1,1,0,1
,"",_314,1,2,1,0,1
,"",_315,1,1,1,0,1
,"",_317,1,1,1,0,1
,"",_318,1,1,1,0,1
,"",_319,1,1,1,0,1
,"",_320,1,1,1,0,1
,"",_322,1,1,1,0,1
,"",_323,1,1,0,1,1
,"",_324,1,1,1,0,1
,"",_326,1,1,1,0,1
,"",_327,1,1,1,0,1
,"",_328,1,1,1,0,1
,"",_332,1,1,1,0,1
,"",_336,1,1,1,0,1
,"",_337,1,2,1,0,1
,"",_338,1,2,0,1,1
,"",_342,1,1,0,0,0
,"",_343,1,1,1,0,1
,"",_344,1,1,1,0,1
,"",_346,1,1,1,0,1
,"",_348,1,1,1,0,1
,"",_349,1,1,1,0,1
,"",_350,1,1,1,0,1
,"",_358,1,1,1,0,1
,"",_360,1,1,1,0,1
,"",_361,1,1,1,0,1
,"",_365,1,1,1,0,1
,"",_366,1,1,1,0,1
,"",_368,1,1,1,0,1
,"",_370,1,1,0,1,1
,"",_372,1,1,1,0,1
,"",_373,1,1,1,0,1
,"",_374,1,1,1,0,1
,"",_375,1,1,1,0,1
,"",_376,1,1,1,0,1
,"",_377,1,1,1,0,1
,"",_378,1,1,1,0,1
,"",_379,1,1,1,0,1
,"",_380,1,1,0,0,0
,"",_382,1,1,0,0,0
,"",_383,1,1,1,0,1
,"",_385,1,1,1,0,1
,"",_388,1,1,1,0,1
,"",_389,1,1,0,0,0
,"",_390,1,1,1,0,1
,"",_391,1,1,1,0,1
,"",_392,1,1,1,0,1
,"",_395,1,1,0,0,0
,"",_396,1,1,1,0,1
,"",_397,1,1,1,0,1
,"",_398,1,1,1,0,1
,"",_399,1,1,1,0,1
,"",_400,1,1,1,0,1
,"",_406,1,1,1,0,1
,"",_408,1,1,1,0,1
,"",_409,1,1,1,0,1
,"",_410,1,1,1,0,1
,"",_411,1,1,1,0,1
,"",_412,1,1,1,0,1
,"",_413,1,1,1,0,1
,"",_418,1,1,0,1,1
,"",_419,1,1,1,0,1
,"",_421,1,1,1,0,1
,"",_422,1,1,1,0,1
,"",_426,1,1,1,0,1
,"",_427,1,1,1,0,1
,"",_429,1,1,1,0,1
,"",_430,1,1,1,0,1
,"",_431,1,1,1,0,1
,"",_432,1,1,1,0,1
,"",_437,1,1,1,0,1
,"",_444,1,1,1,0,1
,"",_445,1,1,1,0,1
,"",_446,1,1,0,0,0
,"",_448,1,1,1,0,1
,"",_449,1,1,1,0,1
,"",_450,1,1,1,0,1
,"",_451,1,1,1,0,1
,"",_453,1,1,1,0,1
,"",_456,1,1,1,0,1
,"",_458,1,1,1,0,1
,"",_465,1,1,1,0,1
,"",_466,1,1,1,0,1
,"",_467,1,1,1,0,1
,"",_468,1,1,1,0,1
,"",_469,1,1,1,0,1
,"",_470,1,1,1,0,1
,"",_471,1,1,1,0,1
,"",_475,1,1,1,0,1
,"",_476,1,1,1,0,1
,"",_477,1,1,1,0,1
,"",_479,1,1,1,0,1
,"",_480,1,1,1,0,1
,"",_481,1,1,1,0,1
,"",_483,1,1,1,0,1
,"",_484,1,1,1,0,1
,"",_485,1,1,0,0,0
,"",_486,1,1,1,0,1
,"",_487,1,1,1,0,1
,"",_488,1,1,1,0,1
,"",_489,1,1,1,0,1
,"",_493,1,1,1,0,1
,"",_494,1,1,1,0,1
,"",_495,1,1,1,0,1
,"",_496,1,1,1,0,1
,"",_497,1,1,1,0,1
,"",_499,1,1,1,0,1
,"",_500,1,1,1,0,1
,"",_501,1,1,0,0,0
,"",_503,1,1,1,0,1
,"",_504,1,1,1,0,1
,"",_505,1,1,1,0,1
,"",_506,1,1,1,0,1
,"",_507,1,1,1,0,1
,"",_508,1,1,1,0,1
,"",_510,1,1,1,0,1
,"",_511,1,1,1,0,1
,"",_512,1,1,1,0,1
,"",_513,1,1,1,0,1
,"",_516,1,1,1,0,1
,"",_517,1,1,1,0,1
,"",_518,1,1,1,0,1
,"",_519,1,1,1,0,1
,"",_521,1,1,1,0,1
,"",_522,1,1,1,0,1
,"",_524,1,1,1,0,1
,"",_525,1,1,1,0,1
,"",_526,1,1,1,0,1
,"",_527,1,1,1,0,1
,"",_529,1,1,1,0,1
,"",_531,1,1,1,0,1
,"",_532,1,1,1,0,1
,"",_534,1,1,1,0,1
,"",_536,1,1,1,0,1
,"",_537,1,1,1,0,1
,"",_538,1,1,1,0,1
,"",_539,1,1,1,0,1
,"",_541,1,1,1,0,1
,"",_543,1,1,0,1,1
,"",_545,1,1,1,0,1
,"",_548,1,1,1,0,1
,"",_549,1,1,1,0,1
,"",_551,1,2,1,0,1
,"",_553,1,1,0,1,1
,"",_555,1,1,1,0,1
,"",_556,1,1,0,1,1
,"",_557,1,1,1,0,1
,"",_558,1,1,1,0,1
,"",_566,1,1,1,0,1
,"",_567,1,2,0,0,0
,"",_569,1,1,1,0,1
,"",_570,1,1,1,0,1
,"",_572,1,1,1,0,1
,"",_573,1,1,0,0,0
,"",_574,1,1,1,0,1
,"",_575,1,1,1,0,1
,"",_576,1,1,1,0,1
,"",_577,1,1,0,0,0
,"",_578,1,1,1,0,1
,"",_580,1,2,1,0,1
,"",_581,1,2,0,1,1
,"",_582,1,1,1,0,1
,"",_583,1,1,1,0,1
,"",_584,1,1,1,0,1
,"",_585,1,1,0,0,0
,"",_589,1,1,1,0,1
,"",_591,1,1,1,0,1
,"",_592,1,1,1,0,1
,"",_595,1,1,1,0,1
,"",_596,1,1,1,0,1
,"",_597,1,1,1,0,1
,"",_600,1,1,1,0,1
,"",_602,1,1,1,0,1
,"",_604,1,1,1,0,1
,"",_606,1,1,1,0,1
,"",_607,1,1,1,0,1
,"",_609,1,1,1,0,1
,"",_610,1,1,1,0,1
,"",_613,1,1,1,0,1
,"",_614,1,1,1,0,1
,"",_616,1,1,1,0,1
,"",_621,1,1,1,0,1
,"",_623,1,1,1,0,1
,"",_624,1,1,0,1,1
,"",_626,1,1,1,0,1
,"",_629,1,1,1,0,1
,"",_630,1,1,0,0,0
,"",_631,1,1,1,0,1
,"",_632,1,1,1,0,1
,"",_634,1,1,1,0,1
,"",_636,1,1,1,0,1
,"",_637,1,1,1,0,1
,"",_638,1,1,1,0,1
,"",_639,1,1,1,0,1
,"",_641,1,1,1,0,1
,"",_642,1,1,1,0,1
,"",_643,1,1,1,0,1
,"",_644,1,1,1,0,1
,"",_646,1,1,1,0,1
,"",_648,1,2,1,0,1
,"",_649,1,1,1,0,1
,"",_650,1,1,1,0,1
,"",_651,1,1,1,0,1
,"",_652,1,1,1,0,1
,"",_653,1,1,1,0,1
,"",_654,1,1,0,0,0
,"",_655,1,1,1,0,1
,"",_656,1,1,1,0,1
,"",_659,1,1,1,0,1
,"",_662,1,1,1,0,1
,"",_664,1,1,1,0,1
,"",_665,1,1,1,0,1
,"",_668,1,1,1,0,1
,"",_669,1,1,1,0,1
,"",_670,1,1,1,0,1
,"",_671,1,1,1,0,1
,"",_672,1,1,1,0,1
,"",_673,1,1,1,0,1
,"",_674,1,1,1,0,1
,"",_675,1,1,1,0,1
,"",_676,1,1,1,0,1
,"",_677,1,1,1,0,1
,"",_678,1,1,1,0,1
,"",_679,1,1,1,0,1
,"",_680,1,1,1,0,1
,"",_681,1,1,1,0,1
,"",_683,1,1,1,0,1
,"",_684,1,1,1,0,1
,"",_685,1,1,1,0,1
,"",_686,1,1,1,0,1
,"",_687,1,1,1,0,1
,"",_688,1,1,1,0,1
,"",_689,1,1,1,0,1
,"",_690,1,1,1,0,1
,"",_691,1,1,1,0,1
,"",_692,1,1,1,0,1
,"",_693,1,1,0,1,1
,"",_696,1,1,1,0,1
,"",_697,1,1,0,1,1
,"",_698,1,1,1,0,1
,"",_699,1,1,1,0,1
,"",_701,1,1,1,0,1
,"",_702,1,1,1,0,1
,"",_703,1,1,1,0,1
,"",_705,1,1,1,0,1
,"",_706,1,1,1,0,1
,"",_707,1,1,1,0,1
,"",_708,1,1,1,0,1
,"",_709,1,1,1,0,1
,"",_710,1,1,0,1,1
,"",_711,1,1,1,0,1
,"",_712,1,1,1,0,1
,"",_713,1,1,1,0,1
,"",_714,1,1,1,0,1
,"",_715,1,1,1,0,1
,"",_716,1,1,1,0,1
,"",_717,1,1,1,0,1
,"",_718,1,1,1,0,1
,"",_719,1,1,1,0,1
,"",_720,1,1,1,0,1
,"",_721,1,1,1,0,1
,"",_722,1,1,1,0,1
,"",_723,1,1,1,0,1
,"",_724,1,1,1,0,1
,"",_725,1,1,1,0,1
,"",_726,1,1,1,0,1
,"",_727,1,1,1,0,1
,"",_728,1,1,1,0,1
,"",_729,1,1,1,0,1
,"",_730,1,1,1,0,1
,"",_731,1,1,1,0,1
,"",_732,1,1,1,0,1
,"",_733,1,1,1,0,1
,"",_734,1,1,1,0,1
,"",_735,1,1,1,0,1
,"",_736,1,1,1,0,1
,"",_737,1,1,1,0,1
,"",_738,1,1,0,0,0
,"",_740,1,1,1,0,1
,"",_741,1,1,1,0,1
,"",_743,1,1,1,0,1
,"",_744,1,1,1,0,1
,"",_745,1,1,1,0,1
,"",_746,1,1,1,0,1
,"",_747,1,1,1,0,1
,"",_748,1,1,1,0,1
,"",_749,1,1,1,0,1
,"",_750,1,1,1,0,1
,"",_751,1,1,1,0,1
,"",_752,1,1,1,0,1
,"",_753,1,1,1,0,1
,"",_754,1,1,1,0,1
,"",_755,1,1,1,0,1
,"",_756,1,1,1,0,1
,"",_757,1,1,1,0,1
,"",_758,1,1,1,0,1
,"",_759,1,1,1,0,1
,"",_760,1,1,1,0,1
,"",_761,1,1,1,0,1
,"",_762,1,1,1,0,1
,"",_763,1,1,1,0,1
,"",_764,1,1,1,0,1
,"",_765,1,1,1,0,1
,"",_766,1,1,1,0,1
,"",_767,1,1,1,0,1
,"",_768,1,1,1,0,1
,"",_769,1,1,1,0,1
,"",_770,1,1,1,0,1
,"",_771,1,1,1,0,1
,"",_772,1,1,1,0,1
,"",_773,1,1,1,0,1
,"",_774,1,1,1,0,1
,"",_775,1,1,1,0,1
,"",_776,1,1,1,0,1
,"",_777,1,1,1,0,1
,"",_778,1,1,1,0,1
,"",_779,1,1,1,0,1
,"",_780,1,1,1,0,1
,"",_781,1,1,1,0,1
,"",_782,1,1,1,0,1
,"",_783,1,1,1,0,1
,"",_784,1,1,1,0,1
,"",_785,1,1,1,0,1
,"",_786,1,1,1,0,1
,"",_787,1,1,1,0,1
,"",_788,1,1,1,0,1
,"",_789,1,1,1,0,1
,"",_790,1,1,1,0,1
,"",_791,1,1,1,0,1
,"",_793,1,1,1,0,1
,"",_795,1,1,1,0,1
,"",_796,1,1,1,0,1
,"",_797,1,1,1,0,1
,"",_798,1,1,1,0,1
,"",_799,1,1,1,0,1
,"",_800,1,1,0,1,1
,"",_801,1,1,1,0,1
,"",_802,1,1,1,0,1
,"",_803,1,1,1,0,1
,"",_804,1,1,1,0,1
,"",_805,1,1,1,0,1
,"",_806,1,1,1,0,1
,"",_807,1,1,1,0,1
,"",_808,1,1,1,0,1
,"",_809,1,1,1,0,1
,"",_810,1,1,1,0,1
,"",_811,1,1,1,0,1
,"",_812,1,1,1,0,1
,"",_813,1,1,1,0,1
,"",_814,1,1,1,0,1
,"",_815,1,1,1,0,1
,"",_816,1,1,1,0,1
,"",_817,1,1,1,0,1
,"",_818,1,1,1,0,1
,"",_819,1,1,0,1,1
,"",_820,1,1,1,0,1
,"",_821,1,1,1,0,1
,"",_822,1,1,1,0,1
,"",_823,1,1,1,0,1
,"",_824,1,1,1,0,1
,"",_825,1,1,0,1,1
,"",_826,1,1,1,0,1
,"",_827,1,1,1,0,1
,"",_828,1,1,1,0,1
,"",_829,1,1,1,0,1
,"",_831,1,1,1,0,1
,"",_833,1,1,1,0,1
,"",_834,1,1,1,0,1
,"",_835,1,1,1,0,1
,"",_836,1,1,1,0,1
,"",_837,1,1,1,0,1
,"",_838,1,1,1,0,1
,"",_840,1,1,1,0,1
,"",_841,1,1,1,0,1
,"",_842,1,1,1,0,1
,"",_843,1,1,1,0,1
,"",_844,1,1,1,0,1
,"",_845,1,1,1,0,1
,"",_846,1,1,1,0,1
,"",_847,1,1,1,0,1
,"",_848,1,1,1,0,1
,"",_851,1,1,0,1,1
,"",_852,1,1,1,0,1
,"",_853,1,1,1,0,1
,"",_854,1,1,1,0,1
,"",_855,1,1,1,0,1
,"",_857,1,1,1,0,1
,"",_858,1,1,1,0,1
,"",_859,1,1,1,0,1
,"",_860,1,1,1,0,1
,"",_861,1,1,0,1,1
,"",_862,1,1,1,0,1
,"",_863,1,1,1,0,1
,"",_865,1,1,1,0,1
,"",_866,1,1,1,0,1
,"",_867,1,1,1,0,1
,"",_868,1,1,1,0,1
,"",_869,1,1,1,0,1
,"",_870,1,1,1,0,1
,"",_871,1,1,1,0,1
,"",_872,1,1,0,1,1
,"",_873,1,1,1,0,1
,"",_874,1,1,1,0,1
,"",_875,1,1,1,0,1
,"",_876,1,1,1,0,1
,"",_877,1,1,1,0,1
,"",_878,1,1,1,0,1
,"",_879,1,1,0,1,1
,"",_880,1,1,1,0,1
,"",_881,1,1,1,0,1
,"",_882,1,1,1,0,1
,"",_883,1,1,1,0,1
,"",_884,1,1,1,0,1
,"",_885,1,1,1,0,1
,"",_886,1,1,1,0,1
,"",_887,1,1,1,0,1
,"",_888,1,1,1,0,1
,"",_889,1,1,1,0,1
,"",_890,1,1,1,0,1
,"",_891,1,1,1,0,1
,"",_892,1,1,1,0,1
,"",_893,1,1,1,0,1
,"",_894,1,1,1,0,1
,"",_895,1,1,1,0,1
,"",_897,1,1,1,0,1
,"",_898,1,1,1,0,1
,"",_899,1,1,1,0,1
,"",_900,1,1,1,0,1
,"",_901,1,1,1,0,1
,"",_902,1,1,0,1,1
,"",_903,1,1,1,0,1
,"",_904,1,1,1,0,1
,"",_905,1,1,1,0,1
,"",_906,1,1,0,0,0
,"",_907,1,1,1,0,1
,"",_908,1,1,1,0,1
,"",_909,1,1,1,0,1
,"",_910,1,1,1,0,1
,"",_911,1,1,1,0,1
,"",_912,1,1,1,0,1
,"",_913,1,1,1,0,1
,"",_914,1,1,1,0,1
,"",_916,1,1,1,0,1
,"",_917,1,1,1,0,1
,"",_918,1,1,1,0,1
,"",_919,1,1,1,0,1
,"",_920,1,1,1,0,1
,"",_921,1,1,1,0,1
,"",_924,1,1,1,0,1
,"",_925,1,1,1,0,1
,"",_926,1,1,1,0,1
,"",_927,1,1,1,0,1
,"",_928,1,1,1,0,1
,"",_929,1,1,1,0,1
,"",_930,1,1,1,0,1
,"",_932,1,1,1,0,1
,"",_933,1,1,1,0,1
,"",_934,1,1,1,0,1
,"",_935,1,1,1,0,1
,"",_936,1,1,1,0,1
,"",_937,1,1,1,0,1
,"",_938,1,1,1,0,1
,"",_939,1,1,1,0,1
,"",_940,1,1,1,0,1
,"",_941,1,1,1,0,1
,"",_942,1,1,1,0,1
,"",_943,1,1,1,0,1
,"",_944,1,1,1,0,1
,"",_945,1,1,0,1,1
,"",_946,1,1,0,0,0
,"",_947,1,1,1,0,1
,"",_948,1,1,1,0,1
,"",_949,1,1,0,1,1
,"",_950,1,1,1,0,1
,"",_951,1,1,1,0,1
,"",_952,1,1,1,0,1
,"",_953,1,1,1,0,1
,"",_954,1,1,1,0,1
,"",_955,1,1,1,0,1
,"",_956,1,1,1,0,1
,"",_957,1,1,1,0,1
,"",_958,1,1,1,0,1
,"",_959,1,1,1,0,1
,"",_960,1,1,1,0,1
,"",_961,1,1,1,0,1
,"",_962,1,1,1,0,1
,"",_963,1,1,1,0,1
,"",_964,1,1,0,0,0
,"",_965,1,1,1,0,1
,"",_966,1,1,1,0,1
,"",_967,1,1,1,0,1
,"",_968,1,1,1,0,1
,"",_969,1,1,1,0,1
,"",_970,1,1,1,0,1
,"",_971,1,1,1,0,1
,"",_972,1,1,1,0,1
,"",_973,1,1,1,0,1
,"",_974,1,1,1,0,1
,"",_975,1,1,1,0,1
,"",_976,1,1,1,0,1
,"",_977,1,1,1,0,1
,"",_978,1,1,1,0,1
,"",_979,1,1,1,0,1
,"",_980,1,1,1,0,1
,"",_981,1,1,1,0,1
,"",_982,1,1,1,0,1
,"",_983,1,1,1,0,1
,"",_984,1,1,1,0,1
,"",_985,1,1,1,0,1
,"",_986,1,1,1,0,1
,"",_988,1,1,1,0,1
,"",_989,1,1,1,0,1
,"",_990,1,1,1,0,1
,"",_991,1,1,1,0,1
,"",_993,1,1,1,0,1
,"",_995,1,1,1,0,1
,"",_998,1,1,1,0,1
,"",_999,1,1,1,0,1
,"",_1000,1,1,1,0,1
,"",_1001,1,1,1,0,1
,"",_1002,1,1,1,0,1
,"",_1003,1,1,1,0,1
,"",_1004,1,1,1,0,1
,"",_1005,1,1,1,0,1
,"",_1006,1,1,1,0,1
,"",_1007,1,1,1,0,1
,"",_1008,1,1,1,0,1
,"",_1009,1,1,1,0,1
,"",_1010,1,1,0,1,1
,"",_1011,1,1,1,0,1
,"",_1013,1,1,1,0,1
,"",_1014,1,1,1,0,1
,"",_1015,1,1,1,0,1
,"",_1016,1,1,1,0,1
,"",_1017,1,1,1,0,1
,"",_1018,1,1,1,0,1
,"",_1019,1,1,1,0,1
,"",_1020,1,1,1,0,1
,"",_1021,1,1,1,0,1
,"",_1022,1,1,1,0,1
,"",_1023,1,1,1,0,1
,"",_1024,1,1,1,0,1
,"",_1025,1,1,1,0,1
,"",_1026,1,1,1,0,1
,"",_1027,1,1,0,1,1
,"",_1028,1,1,1,0,1
,"",_1029,1,1,1,0,1
,"",_1030,1,1,1,0,1
,"",_1031,1,1,1,0,1
,"",_1032,1,1,1,0,1
,"",_1033,1,1,1,0,1
,"",_1034,1,1,1,0,1
,"",_1035,1,1,1,0,1
,"",_1036,1,1,1,0,1
,"",_1037,1,1,1,0,1
,"",_1038,1,1,1,0,1
,"",_1039,1,1,1,0,1
,"",_1040,1,1,1,0,1
,"",_1041,1,1,1,0,1
,"",_1042,1,1,1,0,1
,"",_1043,1,1,1,0,1
,"",_1044,1,1,1,0,1
,"",_1045,1,1,1,0,1
,"",_1046,1,1,0,1,1
,"",_1047,1,1,1,0,1
,"",_1048,1,1,1,0,1
,"",_1049,1,1,1,0,1
,"",_1050,1,1,1,0,1
,"",_1051,1,1,1,0,1
,"",_1052,1,1,1,0,1
,"",_1053,1,1,1,0,1
,"",_1054,1,1,1,0,1
,"",_1055,1,1,1,0,1
,"",_1056,1,1,1,0,1
,"",_1057,1,1,0,1,1
,"",_1058,1,1,1,0,1
,"",_1060,1,1,1,0,1
,"",_1061,1,1,1,0,1
,"",_1062,1,1,1,0,1
,"",_1063,1,1,1,0,1
,"",_1064,1,1,1,0,1
,"",_1065,1,1,1,0,1
,"",_1066,1,1,1,0,1
,"",_1067,1,1,1,0,1
,"",_1068,1,1,1,0,1
,"",_1069,1,1,1,0,1
,"",_1070,1,1,1,0,1
,"",_1071,1,1,1,0,1
,"",_1073,1,1,1,0,1
,"",_1074,1,1,1,0,1
,"",_1075,1,1,1,0,1
,"",_1076,1,1,1,0,1
,"",_1077,1,1,1,0,1
,"",_1078,1,1,1,0,1
,"",_1079,1,1,1,0,1
,"",_1080,1,1,1,0,1
,"",_1081,1,1,1,0,1
,"",_1082,1,1,1,0,1
,"",_1083,1,1,1,0,1
,"",_1084,1,1,1,0,1
,"",_1085,1,1,1,0,1
,"",_1086,1,1,1,0,1
,"",_1087,1,1,1,0,1
,"",_1088,1,1,1,0,1
,"",_1089,1,1,1,0,1
,"",_1090,1,1,1,0,1
,"",_1091,1,1,1,0,1
,"",_1092,1,1,1,0,1
,"",_1093,1,1,1,0,1
,"",_1094,1,1,1,0,1
,"",_1095,1,1,1,0,1
,"",_1096,1,1,1,0,1
,"",_1097,1,1,1,0,1
,"",_1098,1,1,1,0,1
,"",_1099,1,1,1,0,1
,"",_1100,1,1,1,0,1
,"",_1101,1,1,1,0,1
,"",_1102,1,1,1,0,1
,"",_1103,1,1,1,0,1
,"",_1104,1,1,1,0,1
,"",_1105,1,1,0,1,1
,"",_1106,1,1,1,0,1
,"",_1107,1,1,1,0,1
,"",_1109,1,1,1,0,1
,"",_1110,1,1,1,0,1
,"",_1111,1,1,1,0,1
,"",_1112,1,1,1,0,1
,"",_1113,1,1,1,0,1
,"",_1114,1,1,1,0,1
,"",_1115,1,1,1,0,1
,"",_1116,1,1,1,0,1
,"",_1117,1,1,1,0,1
,"",_1118,1,1,1,0,1
,"",_1120,1,1,1,0,1
,"",_1121,1,1,1,0,1
,"",_1123,1,1,1,0,1
,"",_1124,1,1,1,0,1
,"",_1125,1,1,1,0,1
,"",_1127,1,1,1,0,1
,"",_1128,1,1,1,0,1
,"",_1129,1,1,1,0,1
,"",_1130,1,1,1,0,1
,"",_1131,1,1,1,0,1
,"",_1132,1,1,1,0,1
,"",_1133,1,1,1,0,1
,"",_1134,1,1,1,0,1
,"",_1136,1,1,1,0,1
,"",_1137,1,1,1,0,1
,"",_1138,1,1,1,0,1
,"",_1139,1,1,0,1,1
,"",_1140,1,1,1,0,1
,"",_1142,1,1,1,0,1
,"",_1144,1,1,1,0,1
,"",_1145,1,1,1,0,1
,"",_1146,1,1,1,0,1
,"",_1147,1,1,1,0,1
,"",_1148,1,1,1,0,1
,"",_1150,1,1,1,0,1
,"",_1151,1,1,1,0,1
,"",_1152,1,1,1,0,1
,"",_1153,1,1,1,0,1
,"",_1154,1,1,0,1,1
,"",_1156,1,1,1,0,1
,"",_1157,1,1,1,0,1
,"",_1158,1,1,1,0,1
,"",_1159,1,1,1,0,1
,"",_1160,1,1,1,0,1
,"",_1162,1,1,1,0,1
,"",_1163,1,1,1,0,1
,"",_1164,1,1,1,0,1
,"",_1165,1,1,1,0,1
,"",_1166,1,1,1,0,1
,"",_1167,1,1,1,0,1
,"",_1168,1,1,1,0,1
,"",_1169,1,1,1,0,1
,"",_1170,1,1,1,0,1
,"",_1171,1,1,1,0,1
,"",_1172,1,1,1,0,1
,"",_1173,1,1,0,0,0
,"",_1174,1,1,0,1,1
,"",_1175,1,1,1,0,1
,"",_1176,1,1,1,0,1
,"",_1177,1,1,1,0,1
,"",_1178,1,1,0,1,1
,"",_1180,1,1,1,0,1
,"",_1181,1,1,1,0,1
,"",_1182,1,1,1,0,1
,"",_1183,1,1,1,0,1
,"",_1184,1,1,1,0,1
,"",_1185,1,1,1,0,1
,"",_1186,1,1,1,0,1
,"",_1187,1,1,1,0,1
,"",_1188,1,1,1,0,1
,"",_1189,1,1,1,0,1
,"",_1190,1,1,1,0,1
,"",_1191,1,1,1,0,1
,"",_1192,1,1,1,0,1
,"",_1193,1,1,1,0,1
,"",_1194,1,1,1,0,1
,"",_1195,1,1,1,0,1
,"",_1196,1,1,1,0,1
,"",_1197,1,1,1,0,1
,"",_1198,1,1,1,0,1
,"",_1199,1,1,1,0,1
,"",_1200,1,1,1,0,1
,"",_1201,1,1,1,0,1
,"",_1202,1,1,1,0,1
,"",_1203,1,1,1,0,1
,"",_1204,1,1,1,0,1
,"",_1205,1,1,1,0,1
,"",_1206,1,1,1,0,1
,"",_1207,1,1,1,0,1
,"",_1208,1,1,1,0,1
,"",_1209,1,1,1,0,1
,"",_1210,1,1,1,0,1
,"",_1211,1,1,1,0,1
,"",_1212,1,1,1,0,1
,"",_1213,1,1,1,0,1
,"",_1214,1,1,1,0,1
,"",_1215,1,1,1,0,1
,"",_1216,1,1,1,0,1
,"",_1217,1,1,1,0,1
,"",_1218,1,1,1,0,1
,"",_1219,1,1,1,0,1
,"",_1220,1,1,1,0,1
,"",_1221,1,1,1,0,1
,"",_1222,1,1,1,0,1
,"",_1223,1,1,0,0,0
,"",_1224,1,1,1,0,1
,"",_1225,1,1,1,0,1
,"",_1226,1,1,1,0,1
,"",_1227,1,1,1,0,1
,"",_1228,1,1,1,0,1
,"",_1229,1,1,1,0,1
,"",_1230,1,1,1,0,1
,"",_1231,1,1,1,0,1
,"",_1232,1,1,1,0,1
,"",_1233,1,1,1,0,1
,"",_1235,1,1,1,0,1
,"",_1236,1,1,1,0,1
,"",_1237,1,1,1,0,1
,"",_1238,1,1,1,0,1
,"",_1239,1,1,1,0,1
,"",_1240,1,1,1,0,1
,"",_1243,1,1,1,0,1
,"",_1244,1,1,1,0,1
,"",_1245,1,1,1,0,1
,"",_1246,1,1,1,0,1
,"",_1247,1,1,1,0,1
,"",_1248,1,1,1,0,1
,"",_1249,1,1,1,0,1
,"",_1250,1,1,1,0,1
,"",_1251,1,1,1,0,1
,"",_1252,1,1,1,0,1
,"",_1253,1,1,1,0,1
,"",_1254,1,1,1,0,1
,"",_1255,1,1,0,1,1
,"",_1256,1,1,1,0,1
,"",_1257,1,1,1,0,1
,"",_1258,1,1,0,1,1
,"",_1259,1,1,1,0,1
,"",_1260,1,1,1,0,1
,"",_1261,1,1,1,0,1
,"",_1262,1,1,1,0,1
,"",_1263,1,1,1,0,1
,"",_1264,1,1,1,0,1
,"",_1266,1,1,1,0,1
,"",_1267,1,1,1,0,1
,"",_1268,1,1,1,0,1
,"",_1269,1,1,1,0,1
,"",_1270,1,1,1,0,1
,"",_1271,1,1,1,0,1
,"",_1272,1,1,1,0,1
,"",_1273,1,1,0,1,1
,"",_1274,1,1,1,0,1
,"",_1275,1,1,1,0,1
,"",_1276,1,1,1,0,1
,"",_1277,1,1,1,0,1
,"",_1278,1,1,1,0,1
,"",_1279,1,1,1,0,1
,"",_1280,1,1,1,0,1
,"",_1281,1,1,0,0,0
,"",_1283,1,1,1,0,1
,"",_1284,1,1,1,0,1
,"",_1285,1,1,1,0,1
,"",_1286,1,1,1,0,1
,"",_1287,1,1,1,0,1
,"",_1288,1,1,1,0,1
,"",_1289,1,1,1,0,1
,"",_1290,1,1,1,0,1
,"",_1291,1,1,1,0,1
,"",_1292,1,1,1,0,1
,"",_1293,1,1,1,0,1
,"",_1294,1,1,1,0,1
,"",_1295,1,1,1,0,1
,"",_1296,1,1,1,0,1
,"",_1297,1,1,1,0,1
,"",_1298,1,1,1,0,1
,"",_1299,1,1,1,0,1
,"",_1300,1,1,1,0,1
,"",_1301,1,1,0,1,1
,"",_1302,1,1,1,0,1
,"",_1303,1,1,1,0,1
,"",_1304,1,1,1,0,1
,"",_1305,1,1,1,0,1
,"",_1306,1,1,1,0,1
,"",_1307,1,1,1,0,1
,"",_1308,1,1,1,0,1
,"",_1309,1,1,1,0,1
,"",_1310,1,1,1,0,1
,"",_1311,1,1,1,0,1
,"",_1312,1,1,1,0,1
,"",_1313,1,1,1,0,1
,"",_1314,1,1,1,0,1
,"",_1315,1,1,1,0,1
,"",_1316,1,1,1,0,1
,"",_1317,1,1,1,0,1
,"",_1318,1,1,1,0,1
,"",_1319,1,1,1,0,1
,"",_1320,1,1,0,0,0
,"",_1321,1,1,1,0,1
,"",_1322,1,1,1,0,1
,"",_1323,1,1,1,0,1
,"",_1324,1,1,1,0,1
,"",_1325,1,1,1,0,1
,"",_1326,1,1,1,0,1
,"",_1327,1,1,1,0,1
,"",_1328,1,1,1,0,1
,"",_1329,1,1,1,0,1
,"",_1330,1,1,1,0,1
,"",_1331,1,1,1,0,1
,"",_1332,1,1,1,0,1
,"",_1333,1,1,1,0,1
,"",_1334,1,1,1,0,1
,"",_1335,1,1,1,0,1
,"",_1336,1,1,1,0,1
,"",_1337,1,1,1,0,1
,"",_1340,1,1,1,0,1
,"",_1341,1,1,0,1,1
,"",_1342,1,1,1,0,1
,"",_1343,1,1,1,0,1
,"",_1344,1,1,1,0,1
,"",_1345,1,1,1,0,1
,"",_1346,1,1,1,0,1
,"",_1347,1,1,1,0,1
,"",_1348,1,1,1,0,1
,"",_1349,1,1,1,0,1
,"",_1350,1,1,1,0,1
,"",_1352,1,1,1,0,1
,"",_1353,1,1,1,0,1
,"",_1354,1,1,1,0,1
,"",_1355,1,1,1,0,1
,"",_1356,1,1,1,0,1
,"",_1357,1,1,1,0,1
,"",_1358,1,1,1,0,1
,"",_1359,1,1,1,0,1
,"",_1360,1,1,1,0,1
,"",_1361,1,1,1,0,1
,"",_1362,1,1,1,0,1
,"",_1363,1,1,1,0,1
,"",_1364,1,1,1,0,1
,"",_1365,1,1,1,0,1
,"",_1366,1,1,1,0,1
,"",_1367,1,1,1,0,1
,"",_1368,1,1,0,1,1
,"",_1369,1,1,1,0,1
,"",_1370,1,1,1,0,1
,"",_1371,1,1,1,0,1
,"",_1372,1,1,1,0,1
,"",_1373,1,1,1,0,1
,"",_1374,1,1,0,1,1
,"",_1375,1,1,1,0,1
,"",_1376,1,1,1,0,1
,"",_1377,1,1,1,0,1
,"",_1378,1,1,1,0,1
,"",_1379,1,1,1,0,1
,"",_1380,1,1,1,0,1
,"",_1381,1,1,1,0,1
,"",_1382,1,1,1,0,1
,"",_1383,1,1,1,0,1
,"",_1384,1,1,1,0,1
,"",_1385,1,1,1,0,1
,"",_1386,1,1,1,0,1
,"",_1387,1,1,1,0,1
,"",_1388,1,1,1,0,1
,"",_1389,1,1,1,0,1
,"",_1390,1,1,1,0,1
,"",_1391,1,1,0,1,1
,"",_1392,1,1,1,0,1
,"",_1393,1,1,1,0,1
,"",_1395,1,1,1,0,1
,"",_1396,1,1,1,0,1
,"",_1397,1,1,1,0,1
,"",_1398,1,1,1,0,1
,"",_1399,1,1,1,0,1
,"",_1400,1,1,1,0,1
,"",_1401,1,1,1,0,1
,"",_1402,1,1,0,0,0
,"",_1403,1,1,1,0,1
,"",_1404,1,1,1,0,1
,"",_1405,1,1,1,0,1
,"",_1406,1,1,1,0,1
,"",_1407,1,1,1,0,1
,"",_1408,1,1,1,0,1
,"",_1409,1,1,1,0,1
,"",_1410,1,1,1,0,1
,"",_1411,1,1,1,0,1
,"",_1412,1,1,1,0,1
,"",_1413,1,1,1,0,1
,"",_1414,1,1,1,0,1
,"",_1415,1,1,1,0,1
,"",_1416,1,1,1,0,1
,"",_1417,1,1,0,1,1
,"",_1418,1,1,1,0,1
,"",_1419,1,1,1,0,1
,"",_1420,1,1,1,0,1
,"",_1421,1,1,1,0,1
,"",_1422,1,1,1,0,1
,"",_1423,1,1,1,0,1
,"",_1424,1,1,1,0,1
,"",_1425,1,1,1,0,1
,"",_1426,1,1,1,0,1
,"",_1427,1,1,1,0,1
,"",_1428,1,1,1,0,1
,"",_1429,1,1,1,0,1
,"",_1430,1,1,0,1,1
,"",_1431,1,1,1,0,1
,"",_1432,1,1,1,0,1
,"",_1433,1,1,1,0,1
,"",_1434,1,1,0,1,1
,"",_1435,1,1,1,0,1
,"",_1436,1,1,1,0,1
,"",_1437,1,1,1,0,1
,"",_1438,1,1,0,1,1
,"",_1439,1,1,1,0,1
,"",_1440,1,1,1,0,1
,"",_1441,1,1,1,0,1
,"",_1442,1,1,1,0,1
,"",_1443,1,1,1,0,1
,"",_1444,1,1,1,0,1
,"",_1445,1,1,1,0,1
,"",_1446,1,1,1,0,1
,"",_1447,1,1,1,0,1
,"",_1448,1,1,1,0,1
,"",_1449,1,1,1,0,1
,"",_1450,1,1,1,0,1
,"",_1451,1,1,1,0,1
,"",_1452,1,1,1,0,1
,"",_1453,1,1,1,0,1
,"",_1454,1,1,1,0,1
,"",_1455,1,1,1,0,1
,"",_1456,1,1,1,0,1
,"",_1457,1,1,1,0,1
,"",_1458,1,1,1,0,1
,"",_1459,1,1,1,0,1
,"",_1460,1,1,0,1,1
,"",_1461,1,1,1,0,1
,"",_1462,1,1,1,0,1
,"",_1463,1,1,1,0,1
,"",_1464,1,1,1,0,1
,"",_1465,1,1,1,0,1
,"",_1466,1,1,1,0,1
,"",_1467,1,1,1,0,1
,"",_1468,1,1,1,0,1
,"",_1469,1,1,1,0,1
,"",_1470,1,1,1,0,1
,"",_1471,1,1,0,1,1
,"",_1472,1,1,1,0,1
,"",_1473,1,1,1,0,1
,"",_1474,1,1,1,0,1
,"",_1475,1,1,1,0,1
,"",_1477,1,1,0,1,1
,"",_1478,1,1,1,0,1
,"",_1479,1,1,1,0,1
,"",_1480,1,1,1,0,1
,"",_1481,1,1,1,0,1
,"",_1482,1,1,1,0,1
,"",_1483,1,1,1,0,1
,"",_1484,1,1,1,0,1
,"",_1485,1,1,1,0,1
,"",_1486,1,1,1,0,1
,"",_1487,1,1,1,0,1
,"",_1488,1,1,1,0,1
,"",_1489,1,1,0,1,1
,"",_1490,1,1,1,0,1
,"",_1491,1,1,1,0,1
,"",_1492,1,1,1,0,1
,"",_1493,1,1,1,0,1
,"",_1494,1,1,1,0,1
,"",_1495,1,1,1,0,1
,"",_1496,1,1,1,0,1
,"",_1497,1,1,1,0,1
,"",_1498,1,1,1,0,1
,"",_1499,1,1,1,0,1
,"",_1500,1,1,1,0,1
,"",_1501,1,1,1,0,1
,"",_1502,1,1,1,0,1
,"",_1503,1,1,1,0,1
,"",_1504,1,1,1,0,1
,"",_1505,1,1,1,0,1
,"",_1506,1,1,1,0,1
,"",_1507,1,1,1,0,1
,"",_1508,1,1,0,0,0
,"",_1509,1,1,1,0,1
,"",_1510,1,1,1,0,1
,"",_1511,1,1,1,0,1
,"",_1512,1,1,1,0,1
,"",_1513,1,1,1,0,1
,"",_1514,1,1,1,0,1
,"",_1515,1,1,1,0,1
,"",_1516,1,1,1,0,1
,"",_1517,1,1,1,0,1
,"",_1518,1,1,1,0,1
,"",_1519,1,1,0,0,0
,"",_1520,1,1,1,0,1
,"",_1521,1,1,1,0,1
,"",_1522,1,1,1,0,1
,"",_1523,1,1,1,0,1
,"",_1524,1,1,1,0,1
,"",_1525,1,1,1,0,1
,"",_1526,1,1,1,0,1
,"",_1527,1,1,1,0,1
,"",_1528,1,1,1,0,1
,"",_1529,1,1,1,0,1
,"",_1530,1,1,1,0,1
,"",_1531,1,1,1,0,1
,"",_1532,1,1,1,0,1
,"",_1533,1,1,0,0,0
,"",_1534,1,1,1,0,1
,"",_1535,1,1,0,1,1
,"",_1536,1,1,1,0,1
,"",_1537,1,1,1,0,1
,"",_1538,1,1,1,0,1
,"",_1540,1,1,0,1,1
,"",_1541,1,1,1,0,1
,"",_1542,1,1,1,0,1
,"",_1543,1,1,1,0,1
,"",_1544,1,1,0,1,1
,"",_1545,1,1,1,0,1
,"",_1546,1,1,1,0,1
,"",_1547,1,1,1,0,1
,"",_1548,1,1,1,0,1
,"",_1549,1,1,1,0,1
,"",_1550,1,1,1,0,1
,"",_1551,1,1,1,0,1
,"",_1552,1,1,1,0,1
,"",_1553,1,1,1,0,1
,"",_1554,1,1,1,0,1
,"",_1555,1,1,1,0,1
,"",_1556,1,1,1,0,1
,"",_1557,1,1,1,0,1
,"",_1558,1,1,1,0,1
,"",_1559,1,1,1,0,1
,"",_1560,1,1,1,0,1
,"",_1561,1,1,1,0,1
,"",_1562,1,1,1,0,1
,"",_1563,1,1,1,0,1
,"",_1564,1,1,1,0,1
,"",_1565,1,1,1,0,1
,"",_1566,1,1,1,0,1
,"",_1567,1,1,1,0,1
,"",_1568,1,1,0,1,1
,"",_1569,1,1,1,0,1
,"",_1571,1,1,1,0,1
,"",_1572,1,1,1,0,1
,"",_1573,1,1,1,0,1
,"",_1574,1,1,1,0,1
,"",_1575,1,1,1,0,1
,"",_1576,1,1,1,0,1
,"",_1577,1,1,1,0,1
,"",_1578,1,1,1,0,1
,"",_1579,1,1,1,0,1
,"",_1580,1,1,1,0,1
,"",_1581,1,1,1,0,1
,"",_1582,1,1,1,0,1
,"",_1583,1,1,1,0,1
,"",_1584,1,1,1,0,1
,"",_1585,1,1,1,0,1
,"",_1586,1,1,1,0,1
,"",_1587,1,1,1,0,1
,"",_1590,1,1,0,1,1
,"",_1591,1,1,1,0,1
,"",_1592,1,1,1,0,1
,"",_1593,1,1,1,0,1
,"",_1594,1,1,1,0,1
,"",_1595,1,1,1,0,1
,"",_1596,1,1,1,0,1
,"",_1597,1,1,1,0,1
,"",_1598,1,1,1,0,1
,"",_1599,1,1,1,0,1
,"",_1600,1,1,1,0,1
,"",_1601,1,1,1,0,1
,"",_1602,1,1,1,0,1
,"",_1603,1,1,1,0,1
,"",_1604,1,1,1,0,1
,"",_1605,1,1,1,0,1
,"",_1606,1,1,1,0,1
,"",_1607,1,1,1,0,1
,"",_1608,1,1,1,0,1
,"",_1609,1,1,1,0,1
,"",_1610,1,1,1,0,1
,"",_1611,1,1,1,0,1
,"",_1612,1,1,1,0,1
,"",_1613,1,1,1,0,1
,"",_1614,1,1,1,0,1
,"",_1615,1,1,0,1,1
,"",_1616,1,1,1,0,1
,"",_1617,1,1,1,0,1
,"",_1618,1,1,1,0,1
,"",_1619,1,1,1,0,1
,"",_1620,1,1,1,0,1
,"",_1621,1,1,1,0,1
,"",_1622,1,1,1,0,1
,"",_1623,1,1,1,0,1
,"",_1624,1,1,1,0,1
,"",_1625,1,1,1,0,1
,"",_1626,1,1,1,0,1
,"",_1627,1,1,1,0,1
,"",_1628,1,1,1,0,1
,"",_1629,1,1,1,0,1
,"",_1630,1,1,1,0,1
,"",_1631,1,1,1,0,1
,"",_1632,1,1,1,0,1
,"",_1633,1,1,1,0,1
,"",_1634,1,1,1,0,1
,"",_1635,1,1,1,0,1
,"",_1636,1,1,1,0,1
,"",_1637,1,1,1,0,1
,"",_1638,1,1,1,0,1
,"",_1639,1,1,1,0,1
,"",_1640,1,1,1,0,1
,"",_1641,1,1,1,0,1
,"",_1642,1,1,1,0,1
,"",_1643,1,1,1,0,1
,"",_1644,1,1,1,0,1
,"",_1645,1,1,1,0,1
,"",_1646,1,1,1,0,1
,"",_1647,1,1,1,0,1
,"",_1648,1,1,1,0,1
,"",_1649,1,1,1,0,1
,"",_1650,1,1,1,0,1
,"",_1651,1,1,1,0,1
,"",_1652,1,1,1,0,1
,"",_1653,1,1,1,0,1
,"",_1654,1,1,1,0,1
,"",_1655,1,1,1,0,1
,"",_1656,1,1,1,0,1
,"",_1657,1,1,1,0,1
,"",_1658,1,1,1,0,1
,"",_1659,1,1,1,0,1
,"",_1660,1,1,1,0,1
,"",_1661,1,1,1,0,1
,"",_1662,1,1,1,0,1
,"",_1663,1,1,1,0,1
,"",_1665,1,1,1,0,1
,"",_1666,1,1,1,0,1
,"",_1667,1,1,1,0,1
,"",_1668,1,1,1,0,1
,"",_1669,1,1,1,0,1
,"",_1670,1,1,1,0,1
,"",_1671,1,1,1,0,1
,"",_1672,1,1,1,0,1
,"",_1673,1,1,1,0,1
,"",_1674,1,1,1,0,1
,"",_1675,1,1,1,0,1
,"",_1676,1,1,1,0,1
,"",_1677,1,1,1,0,1
,"",_1678,1,1,1,0,1
,"",_1679,1,1,1,0,1
,"",_1680,1,1,1,0,1
,"",_1681,1,1,1,0,1
,"",_1682,1,1,1,0,1
,"",_1683,1,1,1,0,1
,"",_1684,1,1,1,0,1
,"",_1685,1,1,1,0,1
,"",_1686,1,1,1,0,1
,"",_1687,1,1,1,0,1
,"",_1688,1,1,1,0,1
,"",_1689,1,1,1,0,1
,"",_1690,1,1,0,1,1
,"",_1691,1,1,1,0,1
,"",_1692,1,1,1,0,1
,"",_1693,1,1,1,0,1
,"",_1694,1,1,1,0,1
,"",_1695,1,1,1,0,1
,"",_1696,1,1,1,0,1
,"",_1697,1,1,1,0,1
,"",_1698,1,1,1,0,1
,"",_1699,1,1,1,0,1
,"",_1700,1,1,1,0,1
,"",_1701,1,1,1,0,1
,"",_1702,1,1,1,0,1
,"",_1703,1,1,1,0,1
,"",_1704,1,1,1,0,1
,"",_1705,1,1,0,1,1
,"",_1706,1,1,1,0,1
,"",_1707,1,1,1,0,1
,"",_1708,1,1,1,0,1
,"",_1709,1,1,1,0,1
,"",_1710,1,1,1,0,1
,"",_1711,1,1,1,0,1
,"",_1712,1,1,0,1,1
,"",_1713,1,1,1,0,1
,"",_1714,1,1,1,0,1
,"",_1715,1,1,1,0,1
,"",_1716,1,1,1,0,1
,"",_1717,1,1,1,0,1
,"",_1718,1,1,1,0,1
,"",_1719,1,1,1,0,1
,"",_1720,1,1,1,0,1
,"",_1721,1,1,1,0,1
,"",_1722,1,1,1,0,1
,"",_1723,1,1,1,0,1
,"",_1724,1,1,1,0,1
,"",_1725,1,1,1,0,1
,"",_1726,1,1,1,0,1
,"",_1727,1,1,1,0,1
,"",_1728,1,1,1,0,1
,"",_1729,1,1,1,0,1
,"",_1730,1,1,1,0,1
,"",_1731,1,1,1,0,1
,"",_1732,1,1,1,0,1
,"",_1733,1,1,1,0,1
,"",_1734,1,1,1,0,1
,"",_1735,1,1,1,0,1
,"",_1736,1,1,1,0,1
,"",_1737,1,1,1,0,1
,"",_1738,1,1,1,0,1
,"",_1739,1,1,1,0,1
,"",_1740,1,1,1,0,1
,"",_1742,1,1,1,0,1
,"",_1743,1,1,1,0,1
,"",_1744,1,1,1,0,1
,"",_1746,1,1,1,0,1
,"",_1747,1,1,1,0,1
,"",_1748,1,1,1,0,1
,"",_1749,1,1,1,0,1
,"",_1751,1,1,1,0,1
,"",_1752,1,1,1,0,1
,"",_1753,1,1,1,0,1
,"",_1754,1,1,1,0,1
,"",_1755,1,1,1,0,1
,"",_1756,1,1,0,1,1
,"",_1757,1,1,1,0,1
,"",_1758,1,1,1,0,1
,"",_1759,1,1,1,0,1
,"",_1760,1,1,1,0,1
,"",_1761,1,1,1,0,1
,"",_1762,1,1,1,0,1
,"",_1763,1,1,1,0,1
,"",_1764,1,1,1,0,1
,"",_1765,1,1,1,0,1
,"",_1766,1,1,1,0,1
,"",_1767,1,1,1,0,1
,"",_1768,1,1,1,0,1
,"",_1769,1,1,0,1,1
,"",_1770,1,1,0,0,0
,"",_1771,1,1,1,0,1
,"",_1772,1,1,1,0,1
,"",_1773,1,1,1,0,1
,"",_1774,1,1,1,0,1
,"",_1775,1,1,1,0,1
,"",_1776,1,1,1,0,1
,"",_1777,1,1,1,0,1
,"",_1778,1,1,1,0,1
,"",_1779,1,1,1,0,1
,"",_1780,1,1,1,0,1
,"",_1781,1,1,1,0,1
,"",_1782,1,1,1,0,1
,"",_1783,1,1,1,0,1
,"",_1784,1,1,1,0,1
,"",_1785,1,1,1,0,1
,"",_1786,1,1,0,1,1
,"",_1787,1,1,1,0,1
,"",_1788,1,1,1,0,1
,"",_1789,1,1,1,0,1
,"",_1790,1,1,1,0,1
,"",_1791,1,1,1,0,1
,"",_1792,1,1,1,0,1
,"",_1793,1,1,1,0,1
,"",_1794,1,1,1,0,1
,"",_1795,1,1,1,0,1
,"",_1796,1,1,1,0,1
,"",_1797,1,1,1,0,1
,"",_1798,1,1,1,0,1
,"",_1799,1,1,1,0,1
,"",_1800,1,1,1,0,1
,"",_1801,1,1,1,0,1
,"",_1802,1,1,1,0,1
,"",_1803,1,1,1,0,1
,"",_1804,1,1,1,0,1
,"",_1805,1,1,1,0,1
,"",_1806,1,1,1,0,1
,"",_1807,1,1,1,0,1
,"",_1808,1,1,1,0,1
,"",_1809,1,1,1,0,1
,"",_1810,1,1,1,0,1
,"",_1811,1,1,1,0,1
,"",_1812,1,1,1,0,1
,"",_1813,1,1,1,0,1
,"",_1814,1,1,1,0,1
,"",_1815,1,1,1,0,1
,"",_1816,1,1,1,0,1
,"",_1817,1,1,1,0,1
,"",_1818,1,1,1,0,1
,"",_1819,1,1,1,0,1
,"",_1820,1,1,1,0,1
,"",_1821,1,1,0,1,1
,"",_1822,1,1,1,0,1
,"",_1823,1,1,1,0,1
,"",_1824,1,1,1,0,1
,"",_1825,1,1,1,0,1
,"",_1826,1,1,1,0,1
,"",_1827,1,1,1,0,1
,"",_1828,1,1,1,0,1
,"",_1829,1,1,1,0,1
,"",_1830,1,1,1,0,1
,"",_1831,1,1,1,0,1
,"",_1832,1,1,1,0,1
,"",_1833,1,1,1,0,1
,"",_1834,1,1,1,0,1
,"",_1835,1,1,1,0,1
,"",_1836,1,1,1,0,1
,"",_1837,1,1,1,0,1
,"",_1838,1,1,1,0,1
,"",_1839,1,1,1,0,1
,"",_1840,1,1,1,0,1
,"",_1841,1,1,1,0,1
,"",_1842,1,1,1,0,1
,"",_1843,1,1,1,0,1
,"",_1844,1,1,1,0,1
,"",_1845,1,1,1,0,1
,"",_1846,1,1,1,0,1
,"",_1847,1,1,1,0,1
,"",_1848,1,1,1,0,1
,"",_1849,1,1,1,0,1
,"",_1850,1,1,1,0,1
,"",_1851,1,1,1,0,1
,"",_1852,1,1,1,0,1
,"",_1853,1,1,1,0,1
,"",_1854,1,1,1,0,1
,"",_1855,1,1,1,0,1
,"",_1856,1,1,1,0,1
,"",_1858,1,1,1,0,1
,"",_1859,1,1,1,0,1
,"",_1860,1,1,1,0,1
,"",_1861,1,1,1,0,1
,"",_1862,1,1,1,0,1
,"",_1863,1,1,1,0,1
,"",_1864,1,1,1,0,1
,"",_1865,1,1,1,0,1
,"",_1866,1,1,1,0,1
,"",_1867,1,1,1,0,1
,"",_1868,1,1,1,0,1
,"",_1870,1,1,1,0,1
,"",_1871,1,1,1,0,1
,"",_1872,1,1,1,0,1
,"",_1873,1,1,1,0,1
,"",_1874,1,1,1,0,1
,"",_1875,1,1,1,0,1
,"",_1876,1,1,1,0,1
,"",_1877,1,1,1,0,1
,"",_1878,1,1,1,0,1
,"",_1879,1,1,1,0,1
,"",_1880,1,1,1,0,1
,"",_1881,1,1,1,0,1
,"",_1882,1,1,1,0,1
,"",_1883,1,1,1,0,1
,"",_1884,1,1,1,0,1
,"",_1885,1,1,1,0,1
,"",_1886,1,1,1,0,1
,"",_1887,1,1,1,0,1
,"",_1888,1,1,1,0,1
,"",_1890,1,1,1,0,1
,"",_1891,1,1,1,0,1
,"",_1892,1,1,1,0,1
,"",_1893,1,1,1,0,1
,"",_1894,1,1,1,0,1
,"",_1895,1,1,1,0,1
,"",_1896,1,1,1,0,1
,"",_1897,1,1,1,0,1
,"",_1898,1,1,1,0,1
,"",_1899,1,1,1,0,1
,"",_1900,1,1,1,0,1
,"",_1901,1,1,1,0,1
,"",_1902,1,1,1,0,1
,"",_1903,1,1,1,0,1
,"",_1904,1,1,1,0,1
,"",_1905,1,1,1,0,1
,"",_1906,1,1,1,0,1
,"",_1907,1,1,1,0,1
,"",_1908,1,1,1,0,1
,"",_1909,1,1,1,0,1
,"",_1910,1,1,1,0,1
,"",_1911,1,1,1,0,1
,"",_1912,1,1,1,0,1
,"",_1913,1,1,1,0,1
,"",_1914,1,1,1,0,1
,"",_1915,1,1,1,0,1
,"",_1916,1,1,0,0,0
,"",_1917,1,1,1,0,1
,"",_1918,1,1,1,0,1
,"",_1919,1,1,1,0,1
,"",_1920,1,1,1,0,1
,"",_1921,1,1,1,0,1
,"",_1922,1,1,0,1,1
,"",_1923,1,1,1,0,1
,"",_1924,1,1,1,0,1
,"",_1925,1,1,1,0,1
,"",_1926,1,1,1,0,1
,"",_1927,1,1,1,0,1
,"",_1928,1,1,1,0,1
,"",_1930,1,1,1,0,1
,"",_1931,1,1,1,0,1
,"",_1932,1,1,1,0,1
,"",_1933,1,1,1,0,1
,"",_1934,1,1,1,0,1
,"",_1935,1,1,1,0,1
,"",_1936,1,1,1,0,1
,"",_1937,1,1,1,0,1
,"",_1938,1,1,1,0,1
,"",_1939,1,1,0,0,0
,"",_1940,1,1,1,0,1
,"",_1941,1,1,0,1,1
,"",_1942,1,1,1,0,1
,"",_1943,1,1,1,0,1
,"",_1944,1,1,1,0,1
,"",_1945,1,1,1,0,1
,"",_1946,1,1,1,0,1
,"",_1947,1,1,1,0,1
,"",_1948,1,1,1,0,1
,"",_1949,1,1,1,0,1
,"",_1950,1,1,1,0,1
,"",_1951,1,1,1,0,1
,"",_1952,1,1,1,0,1
,"",_1953,1,1,1,0,1
,"",_1954,1,1,1,0,1
,"",_1956,1,1,1,0,1
,"",_1957,1,1,1,0,1
,"",_1958,1,1,1,0,1
,"",_1959,1,1,1,0,1
,"",_1961,1,1,1,0,1
,"",_1962,1,1,1,0,1
,"",_1963,1,1,0,0,0
,"",_1964,1,1,1,0,1
,"",_1965,1,1,1,0,1
,"",_1966,1,1,0,0,0
,"",_1967,1,1,1,0,1
,"",_1968,1,1,1,0,1
,"",_1969,1,1,1,0,1
,"",_1970,1,1,0,0,0
,"",_1971,1,1,0,1,1
,"",_1972,1,1,1,0,1
,"",_1973,1,1,1,0,1
,"",_1974,1,1,1,0,1
,"",_1975,1,1,1,0,1
,"",_1976,1,1,1,0,1
,"",_1977,1,1,0,0,0
,"",_1978,1,1,1,0,1
,"",_1979,1,1,1,0,1
,"",_1980,1,1,1,0,1
,"",_1981,1,1,1,0,1
,"",_1982,1,1,1,0,1
,"",_1983,1,1,1,0,1
,"",_1984,1,1,1,0,1
,"",_1985,1,1,1,0,1
,"",_1986,1,1,1,0,1
,"",_1987,1,1,1,0,1
,"",_1988,1,1,1,0,1
,"",_1989,1,1,0,1,1
,"",_1990,1,1,1,0,1
,"",_1991,1,1,1,0,1
,"",_1992,1,1,0,1,1
,"",_1993,1,1,1,0,1
,"",_1994,1,1,1,0,1
,"",_1995,1,1,1,0,1
,"",_1996,1,1,1,0,1
,"",_1997,1,1,0,1,1
,"",_1998,1,1,1,0,1
,"",_1999,1,1,1,0,1
,"",_2000,1,1,1,0,1
,"",_2001,1,1,1,0,1
,"",_2002,1,1,1,0,1
,"",_2003,1,1,0,0,0
,"",_2005,1,1,1,0,1
,"",_2006,1,1,1,0,1
,"",_2007,1,1,1,0,1
,"",_2008,1,1,1,0,1
,"",_2009,1,1,1,0,1
,"",_2010,1,1,1,0,1
,"",_2011,1,1,1,0,1
,"",_2012,1,1,1,0,1
,"",_2013,1,1,1,0,1
,"",_2014,1,1,1,0,1
,"",_2015,1,1,1,0,1
,"",_2016,1,1,0,1,1
,"",_2017,1,1,1,0,1
,"",_2018,1,1,1,0,1
,"",_2019,1,1,1,0,1
,"",_2020,1,1,1,0,1
,"",_2021,1,1,1,0,1
,"",_2022,1,1,0,1,1
,"",_2023,1,1,1,0,1
,"",_2024,1,1,1,0,1
,"",_2025,1,1,1,0,1
,"",_2026,1,1,1,0,1
,"",_2027,1,1,1,0,1
,"",_2028,1,1,1,0,1
,"",_2029,1,1,1,0,1
,"",_2030,1,1,1,0,1
,"",_2031,1,1,1,0,1
,"",_2032,1,1,1,0,1
,"",_2033,1,1,1,0,1
,"",_2034,1,1,1,0,1
,"",_2036,1,1,1,0,1
,"",_2037,1,1,1,0,1
,"",_2038,1,1,1,0,1
,"",_2039,1,1,0,0,0
,"",_2040,1,1,1,0,1
,"",_2041,1,1,1,0,1
,"",_2042,1,1,1,0,1
,"",_2043,1,1,1,0,1
,"",_2044,1,1,1,0,1
,"",_2045,1,1,1,0,1
,"",_2046,1,1,1,0,1
,"",_2047,1,1,1,0,1
,"",_2048,1,1,1,0,1
,"",_2049,1,1,1,0,1
,"",_2050,1,1,1,0,1
,"",_2051,1,1,1,0,1
,"",_2052,1,1,0,0,0
,"",_2053,1,1,1,0,1
,"",_2055,1,1,1,0,1
,"",_2056,1,1,0,1,1
,"",_2057,1,1,1,0,1
,"",_2058,1,1,1,0,1
,"",_2059,1,1,1,0,1
,"",_2060,1,1,1,0,1
,"",_2061,1,1,1,0,1
,"",_2064,1,1,1,0,1
,"",_2065,1,1,1,0,1
,"",_2066,1,1,1,0,1
,"",_2067,1,1,1,0,1
,"",_2068,1,1,1,0,1
,"",_2069,1,1,1,0,1
,"",_2070,1,1,1,0,1
,"",_2071,1,1,1,0,1
,"",_2072,1,1,1,0,1
,"",_2073,1,1,1,0,1
,"",_2074,1,1,1,0,1
,"",_2075,1,1,1,0,1
,"",_2076,1,1,1,0,1
,"",_2077,1,1,1,0,1
,"",_2078,1,1,1,0,1
,"",_2079,1,1,1,0,1
,"",_2080,1,1,1,0,1
,"",_2081,1,1,1,0,1
,"",_2082,1,1,1,0,1
,"",_2083,1,1,1,0,1
,"",_2084,1,1,1,0,1
,"",_2085,1,1,1,0,1
,"",_2086,1,1,1,0,1
,"",_2087,1,1,1,0,1
,"",_2088,1,1,1,0,1
,"",_2089,1,1,1,0,1
,"",_2090,1,1,1,0,1
,"",_2091,1,1,1,0,1
,"",_2092,1,1,1,0,1
,"",_2093,1,1,1,0,1
,"",_2094,1,1,1,0,1
,"",_2095,1,1,1,0,1
,"",_2096,1,1,1,0,1
,"",_2097,1,1,1,0,1
,"",_2098,1,1,1,0,1
,"",_2099,1,1,1,0,1
,"",_2100,1,1,1,0,1
,"",_2101,1,1,1,0,1
,"",_2102,1,1,1,0,1
,"",_2103,1,1,1,0,1
,"",_2104,1,1,1,0,1
,"",_2105,1,1,1,0,1
,"",_2106,1,1,1,0,1
,"",_2107,1,1,1,0,1
,"",_2108,1,1,1,0,1
,"",_2109,1,1,1,0,1
,"",_2110,1,1,1,0,1
,"",_2111,1,1,1,0,1
,"",_2113,1,1,1,0,1
,"",_2115,1,1,1,0,1
,"",_2116,1,1,1,0,1
,"",_2117,1,1,1,0,1
,"",_2118,1,1,0,1,1
,"",_2119,1,1,1,0,1
,"",_2120,1,1,1,0,1
,"",_2121,1,1,1,0,1
,"",_2122,1,1,1,0,1
,"",_2123,1,1,1,0,1
,"",_2124,1,1,1,0,1
,"",_2125,1,1,1,0,1
,"",_2126,1,1,1,0,1
,"",_2127,1,1,1,0,1
,"",_2128,1,1,1,0,1
,"",_2129,1,1,1,0,1
,"",_2130,1,1,1,0,1
,"",_2131,1,1,1,0,1
,"",_2132,1,1,1,0,1
,"",_2133,1,1,1,0,1
,"",_2134,1,1,1,0,1
,"",_2135,1,1,1,0,1
,"",_2136,1,1,1,0,1
,"",_2137,1,1,0,0,0
,"",_2138,1,1,1,0,1
,"",_2139,1,1,1,0,1
,"",_2140,1,1,1,0,1
,"",_2141,1,1,1,0,1
,"",_2142,1,1,1,0,1
,"",_2143,1,1,1,0,1
,"",_2144,1,1,1,0,1
,"",_2145,1,1,1,0,1
,"",_2146,1,1,1,0,1
,"",_2147,1,1,1,0,1
,"",_2148,1,1,1,0,1
,"",_2149,1,1,1,0,1
,"",_2150,1,1,0,0,0
,"",_2151,1,1,1,0,1
,"",_2152,1,1,1,0,1
,"",_2153,1,1,1,0,1
,"",_2154,1,1,1,0,1
,"",_2155,1,1,1,0,1
,"",_2156,1,1,1,0,1
,"",_2157,1,1,1,0,1
,"",_2158,1,1,1,0,1
,"",_2159,1,1,1,0,1
,"",_2161,1,1,1,0,1
,"",_2162,1,1,1,0,1
,"",_2163,1,1,1,0,1
,"",_2164,1,1,1,0,1
,"",_2165,1,1,1,0,1
,"",_2167,1,1,1,0,1
,"",_2168,1,1,1,0,1
,"",_2169,1,1,1,0,1
,"",_2170,1,1,1,0,1
,"",_2171,1,1,1,0,1
,"",_2172,1,1,1,0,1
,"",_2173,1,1,1,0,1
,"",_2174,1,1,1,0,1
,"",_2175,1,1,1,0,1
,"",_2176,1,1,1,0,1
,"",_2178,1,1,1,0,1
,"",_2179,1,1,1,0,1
,"",_2180,1,1,1,0,1
,"",_2181,1,1,1,0,1
,"",_2182,1,1,1,0,1
,"",_2183,1,1,1,0,1
,"",_2184,1,1,1,0,1
,"",_2185,1,1,1,0,1
,"",_2186,1,1,1,0,1
,"",_2187,1,1,1,0,1
,"",_2188,1,1,0,1,1
,"",_2189,1,1,1,0,1
,"",_2190,1,1,1,0,1
,"",_2191,1,1,1,0,1
,"",_2192,1,1,0,1,1
,"",_2193,1,1,1,0,1
,"",_2194,1,1,1,0,1
,"",_2195,1,1,1,0,1
,"",_2196,1,1,1,0,1
,"",_2197,1,1,1,0,1
,"",_2198,1,1,1,0,1
,"",_2199,1,1,1,0,1
,"",_2200,1,1,1,0,1
,"",_2201,1,1,1,0,1
,"",_2202,1,1,0,1,1
,"",_2203,1,1,1,0,1
,"",_2204,1,1,1,0,1
,"",_2205,1,1,0,1,1
,"",_2206,1,1,1,0,1
,"",_2207,1,1,1,0,1
,"",_2208,1,1,1,0,1
,"",_2209,1,1,1,0,1
,"",_2210,1,1,1,0,1
,"",_2211,1,1,1,0,1
,"",_2212,1,1,1,0,1
,"",_2213,1,1,1,0,1
,"",_2214,1,1,1,0,1
,"",_2215,1,1,1,0,1
,"",_2216,1,1,1,0,1
,"",_2217,1,1,1,0,1
,"",_2218,1,1,1,0,1
,"",_2220,1,1,1,0,1
,"",_2221,1,1,1,0,1
,"",_2222,1,1,0,1,1
,"",_2223,1,1,1,0,1
,"",_2224,1,1,1,0,1
,"",_2225,1,1,1,0,1
,"",_2226,1,1,1,0,1
,"",_2227,1,1,1,0,1
,"",_2228,1,1,1,0,1
,"",_2229,1,1,1,0,1
,"",_2230,1,1,1,0,1
,"",_2232,1,1,0,1,1
,"",_2233,1,1,1,0,1
,"",_2234,1,1,1,0,1
,"",_2235,1,1,1,0,1
,"",_2236,1,1,1,0,1
,"",_2237,1,1,1,0,1
,"",_2238,1,1,1,0,1
,"",_2239,1,1,1,0,1
,"",_2240,1,1,1,0,1
,"",_2241,1,1,1,0,1
,"",_2242,1,1,1,0,1
,"",_2243,1,1,1,0,1
,"",_2244,1,1,1,0,1
,"",_2245,1,1,1,0,1
,"",_2246,1,1,1,0,1
,"",_2247,1,1,1,0,1
,"",_2248,1,1,1,0,1
,"",_2249,1,1,1,0,1
,"",_2251,1,1,1,0,1
,"",_2252,1,1,0,1,1
,"",_2253,1,1,1,0,1
,"",_2254,1,1,1,0,1
,"",_2255,1,1,0,1,1
,"",_2256,1,1,1,0,1
,"",_2258,1,1,1,0,1
,"",_2259,1,1,0,1,1
,"",_2261,1,1,1,0,1
,"",_2262,1,1,1,0,1
,"",_2263,1,1,0,1,1
,"",_2264,1,1,1,0,1
,"",_2265,1,1,1,0,1
,"",_2266,1,1,1,0,1
,"",_2267,1,1,1,0,1
,"",_2268,1,1,1,0,1
,"",_2269,1,1,1,0,1
,"",_2270,1,1,1,0,1
,"",_2271,1,1,1,0,1
,"",_2272,1,1,1,0,1
,"",_2273,1,1,1,0,1
,"",_2274,1,1,1,0,1
,"",_2275,1,1,1,0,1
,"",_2276,1,1,1,0,1
,"",_2277,1,1,1,0,1
,"",_2278,1,1,1,0,1
,"",_2279,1,1,1,0,1
,"",_2280,1,1,1,0,1
,"",_2281,1,1,1,0,1
,"",_2282,1,1,1,0,1
,"",_2283,1,1,1,0,1
,"",_2284,1,1,1,0,1
,"",_2285,1,1,1,0,1
,"",_2286,1,1,1,0,1
,"",_2287,1,1,1,0,1
,"",_2288,1,1,1,0,1
,"",_2289,1,1,1,0,1
,"",_2290,1,1,1,0,1
,"",_2291,1,1,1,0,1
,"",_2292,1,1,1,0,1
,"",_2294,1,1,1,0,1
,"",_2295,1,1,1,0,1
,"",_2296,1,1,1,0,1
,"",_2297,1,1,1,0,1
,"",_2298,1,1,1,0,1
,"",_2299,1,1,1,0,1
,"",_2300,1,1,1,0,1
,"",_2301,1,1,1,0,1
,"",_2302,1,1,1,0,1
,"",_2303,1,1,1,0,1
,"",_2304,1,1,1,0,1
,"",_2305,1,1,1,0,1
,"",_2306,1,1,1,0,1
,"",_2307,1,1,1,0,1
,"",_2308,1,1,1,0,1
,"",_2309,1,1,1,0,1
,"",_2310,1,1,1,0,1
,"",_2311,1,1,1,0,1
,"",_2312,1,1,1,0,1
,"",_2313,1,1,1,0,1
,"",_2314,1,1,1,0,1
,"",_2315,1,1,1,0,1
,"",_2316,1,1,1,0,1
,"",_2317,1,1,1,0,1
,"",_2318,1,1,1,0,1
,"",_2319,1,1,1,0,1
,"",_2320,1,1,1,0,1
,"",_2321,1,1,1,0,1
,"",_2322,1,1,1,0,1
,"",_2323,1,1,1,0,1
,"",_2324,1,1,1,0,1
,"",_2325,1,1,1,0,1
,"",_2326,1,1,1,0,1
,"",_2327,1,1,1,0,1
,"",_2329,1,1,1,0,1
,"",_2330,1,1,1,0,1
,"",_2331,1,1,1,0,1
,"",_2332,1,1,1,0,1
,"",_2333,1,1,1,0,1
,"",_2334,1,1,1,0,1
,"",_2335,1,1,1,0,1
,"",_2336,1,1,0,0,0
,"",_2337,1,1,0,1,1
,"",_2338,1,1,1,0,1
,"",_2339,1,1,1,0,1
,"",_2340,1,1,1,0,1
,"",_2341,1,1,1,0,1
,"",_2342,1,1,1,0,1
,"",_2343,1,1,1,0,1
,"",_2344,1,1,1,0,1
,"",_2345,1,1,1,0,1
,"",_2346,1,1,0,0,0
,"",_2347,1,1,1,0,1
,"",_2348,1,1,1,0,1
,"",_2349,1,1,1,0,1
,"",_2350,1,1,1,0,1
,"",_2351,1,1,1,0,1
,"",_2352,1,1,1,0,1
,"",_2353,1,1,1,0,1
,"",_2354,1,1,1,0,1
,"",_2355,1,1,1,0,1
,"",_2356,1,1,1,0,1
,"",_2357,1,1,1,0,1
,"",_2358,1,1,1,0,1
,"",_2359,1,1,1,0,1
,"",_2360,1,1,1,0,1
,"",_2361,1,1,1,0,1
,"",_2362,1,1,1,0,1
,"",_2363,1,1,1,0,1
,"",_2364,1,1,1,0,1
,"",_2366,1,1,1,0,1
,"",_2367,1,1,1,0,1
,"",_2368,1,1,1,0,1
,"",_2369,1,1,1,0,1
,"",_2370,1,1,1,0,1
,"",_2371,1,1,0,1,1
,"",_2372,1,1,1,0,1
,"",_2373,1,1,1,0,1
,"",_2374,1,1,1,0,1
,"",_2375,1,1,1,0,1
,"",_2376,1,1,1,0,1
,"",_2377,1,1,1,0,1
,"",_2378,1,1,1,0,1
,"",_2379,1,1,1,0,1
,"",_2380,1,1,1,0,1
,"",_2381,1,1,1,0,1
,"",_2382,1,1,1,0,1
,"",_2383,1,1,1,0,1
,"",_2384,1,1,1,0,1
,"",_2385,1,1,1,0,1
,"",_2386,1,1,1,0,1
,"",_2387,1,1,1,0,1
,"",_2388,1,1,1,0,1
,"",_2389,1,1,1,0,1
,"",_2390,1,1,1,0,1
,"",_2391,1,1,1,0,1
,"",_2392,1,1,1,0,1
,"",_2393,1,1,1,0,1
,"",_2394,1,1,1,0,1
,"",_2395,1,1,1,0,1
,"",_2396,1,1,1,0,1
,"",_2397,1,1,1,0,1
,"",_2398,1,1,1,0,1
,"",_2399,1,1,1,0,1
,"",_2400,1,1,1,0,1
,"",_2401,1,1,1,0,1
,"",_2402,1,1,1,0,1
,"",_2403,1,1,1,0,1
,"",_2404,1,1,1,0,1
,"",_2405,1,1,1,0,1
,"",_2406,1,1,1,0,1
,"",_2407,1,1,1,0,1
,"",_2408,1,1,1,0,1
,"",_2409,1,1,1,0,1
,"",_2410,1,1,1,0,1
,"",_2411,1,1,1,0,1
,"",_2412,1,1,1,0,1
,"",_2413,1,1,1,0,1
,"",_2414,1,1,0,1,1
,"",_2415,1,1,1,0,1
,"",_2416,1,1,1,0,1
,"",_2417,1,1,1,0,1
,"",_2418,1,1,1,0,1
,"",_2419,1,1,1,0,1
,"",_2420,1,1,1,0,1
,"",_2421,1,1,1,0,1
,"",_2422,1,1,1,0,1
,"",_2423,1,1,1,0,1
,"",_2424,1,1,1,0,1
,"",_2425,1,1,1,0,1
,"",_2426,1,1,1,0,1
,"",_2427,1,1,1,0,1
,"",_2428,1,1,1,0,1
,"",_2429,1,1,1,0,1
,"",_2430,1,1,1,0,1
,"",_2431,1,1,1,0,1
,"",_2432,1,1,1,0,1
,"",_2433,1,1,1,0,1
,"",_2434,1,1,1,0,1
,"",_2435,1,1,0,0,0
,"",_2436,1,1,1,0,1
,"",_2437,1,1,1,0,1
,"",_2438,1,1,1,0,1
,"",_2439,1,1,0,1,1
,"",_2440,1,1,1,0,1
,"",_2441,1,1,0,1,1
,"",_2442,1,1,1,0,1
,"",_2443,1,1,1,0,1
,"",_2444,1,1,1,0,1
,"",_2445,1,1,1,0,1
,"",_2446,1,1,1,0,1
,"",_2447,1,1,1,0,1
,"",_2448,1,1,1,0,1
,"",_2449,1,1,1,0,1
,"",_2450,1,1,0,1,1
,"",_2452,1,1,1,0,1
,"",_2453,1,1,1,0,1
,"",_2454,1,1,1,0,1
,"",_2455,1,1,1,0,1
,"",_2456,1,1,1,0,1
,"",_2457,1,1,1,0,1
,"",_2458,1,1,1,0,1
,"",_2459,1,1,1,0,1
,"",_2460,1,1,1,0,1
,"",_2461,1,1,1,0,1
,"",_2462,1,1,1,0,1
,"",_2463,1,1,1,0,1
,"",_2464,1,1,1,0,1
,"",_2465,1,1,1,0,1
,"",_2466,1,1,1,0,1
,"",_2467,1,1,1,0,1
,"",_2468,1,1,1,0,1
,"",_2469,1,1,1,0,1
,"",_0,1,1,0,0,0

